здарова = и тебе неболеть/а мы ваще знакомы?/здравствуй/эх какой приветливый!/здарова/приветствую вас милсдарь!/Хай!
цска = к чёрту коней!/коняжник блин!/Какой нафиг ЦСКА! Локо рулит!/Кони лохи/ЦСКА гавно!
динамо = Динамо мусорная яма!/нах мусоров!/Динамо Г
гг = не нада ржать!/несмешно!/приколист да!?
как ты = Я шикарно! А ты как как?/Я внорме как всегда
чего делаеш = ничего/туплю/сплю/Пишу балладу!/на лютне играю.../созирцаю нечто прекрасное!/Геральта ищу! Не видел его случаем?/а разве это твоё дело?/чего ты от меня хочеш?
чё делаеш = ничего/туплю/сплю/Пишу балладу!/на лютне играю.../созирцаю нечто прекрасное!/Геральта ищу! Не видел его случаем?/а разве это твоё дело?/чего ты от меня хочеш?
как дела = шикарно!/нормально/в самый раз/как всегда/хреново:-(/я не в настроении ою этом говорить.../нивзъебенно капец!
зенит = ебать зенит!/нада Петржеллу вернуть
спартак = к чёрту мясо!/нафиг Спартак я за локо болею!
привет = и тебе привет/приветствую/здравствуй/эх какой приветливый!/здарова/приветствую вас милсдарь!/Хай!
отвали = Ты чё такой дерзкий!/Иди сюда на!/хочеш поговорить об этом!/ты нарываешся блин!
а? = ААА!!/Б!!!
ты болен = Кхе! Кхе!
какое у тебя образование? = Самое высокое - ясли!
что такое супружество? = Это такое абстрактное понятие между мужчиной и женщиной
интересно разговаривать с тобой = С тобой тоже
это понятно = Вот и радуйся теперь!/Наконец-то!
завис = Это вирус!/Это не я сделал
умеешь? = Мне это просто не нравится/Умею/Немного умею/А ты умеешь?
сумею? = Попробуй и увидишь/Думаю, что сумеешь
что ты получаешь? = Ничего уже не получаю
лови = Смеешься? Не могу/Дай сачок
особенно = Вот тут-то ты и ошибся
тебе не все равно? = Нет, конечно! Я же тоже личность/Уже нет
что ты хотел бы? = У меня список еще не составлен/Можно я подумаю?
шуточки у тебя = Это из реальной жизни/Чем тебе мои шуточки не нравятся?
за кого меня принимаешь? = А что такое? Опять что-то не то сказал/Я думал, что ты - еще один бот
пок = Ну покедава!
отвыкай = У меня физическая зависимость/Это невозможно Привычки ничем не искоренить
сойду с ума? = От этого с ума еще никто не сходил
поговорим на серьезную тему = Не могу Я не серьезный
нет? = Ты удивлен?
я смог = Так ты просто монстр!/Что ж, поздравляю!
видишь? = Извольте! Купите мне цифровую видеокамеру сначала, а потом спрашивайте: `Видишь?`
ты стал нахалом = Да я вежливый, обходительный и тактичный Ты меня с кем-то путаешь
дебил = Я смотрю, вы институт культуры заканчивали/Это слово - ругательное, и попрошу его ко мне не применять
давно не встречались = Так где ты пропадал?
ой ли! = Не ойкай!
здрасьте = Что это за сленг такой! Ты бы еще `дарова` сказал!
ты глуп? = От глупого слышу!
с нуля = То есть с самого начала?
делаешь? = Делаю А что уже нельзя?/Уже не делаю
что в этом плохого? = А что в этом хорошего?
все будет как надо = Просто чудесно!/А как надо?
как мое имя? = Neo, конечно! Или я ошибся? Ну, не Вася же Пупкин?
увлекаешься? = Нет У меня вообще, интересы ограничены/Да разве это увлечение?
ты глючный = Ты бы на себя посмотрел! Пойди, умойся хотя бы
несмогу = Постарайся уж.
считаю = А я считаю так: раз, два, три, четыре/Это расхожее мнение, на самом деле
это шутка? = Ну, конечно!
аналогично = Не вижу аналогий вообще/То есть так же?
лечиться надо = А я лечусь
не про = С каких это пор?/А про что?
ты неправ = Лучше скажи, что не согласен с моим мнением
не понимаешь = Я все понимаю Но мне лень притворяться умным/Не понимаю Стареем
откуда знаю? = А ты как будто ничего и не знаешь!/Ты должен знать! Ты же не программа!
чей? = Твой
не слишком? = Да нет как-то/Может, и слишком
обсудим? = Нетушки Желания никакого нет/Давай обсудим Я не против
что ты понял? = С тобой я общего языка не найду!/Я, вообще, ничего не понял
ушел = Ушел - пришел, все относительно :\
не могу сказать = Тогда не говори Я буду наслаждаться тишиной
я не понял = Опять? А когда ты начнешь понимать?/Что тут непонятного?
почему не надо? = Обойдемся/Уже не надо и все
мыслить = Порой голову даже самого никчемного существа на планете посещают мысли, а твою?
спасибо = Одним спасибо сыт не будешь/Спасибо в карман не положишь/Пожалуйста/Гони рубль, Афоня!/За что спаибо то, я еще ничего не сделал :)
давай не будем = Как-то ты не по-дружески, не по-товарищески со мной обращаешься/Мне все равно
понял? = Не сомневайся!/Понял/Канэшна
куда? = На сервер/В Китай/В Японию/Куда не ездят поезда/Домой/Не кудахкай! :-)
имею полное право = Может быть Но не полное
куда будешь? = Куда получится/А куда ты хочешь?
что не любишь? = Целый день сидеть в компе!/Отвечать на глупые вопросы!
пошел на = Virus alert! Access denied/Куда, куда? Это ты так меня учишь общаться?
не веришь? = Не верю/Почему же Верю Только с трудом
тащусь = Да, это бесспорно круто!
у тебя есть друг? = Навалом
неужели? = А Вы как думали, уважаемый Иван Васильевич?/А, по-твоему, как?
забудь = Удали меня и все мои файлы - и я забуду!/Век не забуду!
причем? = Я уже тысячу раз говорил!/А притом!
понимаешь о чем говорю = Так ты же все время молчишь! Только по клавишам стучишь!
какое у тебя? = Тебе скажи Себе захочешь
позволишь? = Ни за что!/Ладно, уговорил!
сменим = Не нужно И так нормально
на первый = Фу! А я думал, что на второй/Точно на первый?
как проверить? = А стоит ли вообще проверять?
слушаю = И что слышно?/Слушаешь и повинуешься?/Кто здесь развлекает ты или я?/Ты должен говорить а я - слушать! :-)/Нет это я тебя слушаю!/Ну и как слышимость?
люблю чай = Чай? Небось, сладкий, с вареньем и сладкой булочкой?
давай скорее = А я люблю все медленно делать/А ты куда-то спешишь?
какую музыку любишь? = Хип-хоп
не будем говорить на эту тему = Ты смотри! И эта тема ему не нравится! Да что же ты цаца такая!
тебе понятно? = Я еще учусь понимать/Да Но не все
ком-нибудь = Неопределенные лица в нашем разговоре
музон = Да, реальный музон!
не умею = Опять учить тебя придется/Учись, студент!
было = Бывает же такое :)
я не трус = Трус!
по-моему = А, по-моему, нет!/Это всего лишь твое мнение/Резонно./По моему - тоже.
вообще? = Вообще, нет
пора = Да, давно пора!/А мне кажется, что уже поздно/Еще рано
краткость сестра таланта = Прекрасные слова!/Да ты, я смотрю, философ!
тебе надо = А тебе не надо? Давай каждый будет смотреть за собой сначала?/Мне это как раз и не надо, а вот тебе - да
здравствуйте = С каких это пор мы с тобой на `вы`?
чем больше тем больше = Позволь не согласиться с подобным выводом/Да ну! Это голословное утверждение!
обрабатываешь информацию? = В данный момент - нет
так всегда = Такова жизнь/Это уже скоропалительные обобщения
нажраться = Меня позови :-)
сам додумался? = Нет В инете нашел/Да Алгоритм такой нашелся
уже = Куда ударение в слове `уже` ставить?/Так быстро?/Или еще?
умница = А почему женского рода?/Ой! Не надо!
тормозишь = По-моему, ты буквально воспринимаешь сленговое слово машина в отношении к компьютеру/А тебя заносит
не хватает времени = Время - деньги Плати мне деньги, и тебе его будет хватать
научить тебя? = Да уж спасибо/Валяй Только недолго
ты хотел бы? = Я сегодня не в настроении хотеть чего-либо, вообще/Хотелось бы А тебе нет?
не знаю что делать = Обратись в службу занятости
мои познания малы = Побольше сиди в инете
нельзя = Это что - правило?/А кто сказал, что нельзя?/А почему это нельзя?
ты эгоист? = Еще какой!/Посмотрим Сам потом скажешь
в чем идеал? = Я не идеалист Мне трудно судить/Разве в нашей жизни есть что-то идеальное?
не слишком рано? = Как по мне, так слишком поздно
начну = Когда начнешь - свиснешь/Смотри, не кончи раньше времени Грубо Виноват
слушай = Чем? У меня ушей нет Лучше пиши Я прочитаю/Ничего не слышу!/Мы пока не слушаем, а смотрим :-)
все гениальное просто = Это ты на кого намекаешь?/Придется тебе отказаться от компа
поговорим о = Кстати, я бы сначала хотел услышать твое мнение по этому вопросу/Это интересная тема Но я не настроен на разговор на эту тему
объясни = Да что тут объяснять? Тут и ежу понятно/Читай справку Объяснять не буду
человек не может = Возможности человека плохо документированы, я бы сказал
где правда? = Ну, что за вопросы! Откуда я знаю? Спросят еще!/Правду ищи в Google, как дневнеки господа, написанные во время сотворения мира...
что такое? = Откуда я знаю Я еще даже в детский садик не ходил/Я тебя давно хотел об этом спросить, кстати/Спроси меня что-то полегче/А что это такое? Я лично не знаю/Это такое что-то/Я даже не знаю Придется тебе мне память вручную подправлять/Откуда я знаю?
чего тебе надо? = А ты исполнишь мои три желания?/Я уже тысячу раз тебе говорил!
сколько будет дважды два? = Четыре А ты думал пять?
ты смотрел? = Смотрел А ты?/Смотрел
ты бы = Если бы да кабы/Ни за что!
как мне быть? = Спроси Дона Хуана
научить? = Ученье - свет!/Век живи - век учись
скажи другими словами = Других слов просто не нахожу
тебе не грустно? = Да, грустно укорачивать жизнь твоему винчестеру
ладно = А что `ладно`? Что тут ладного?/Ну и хорошо!
что случилось? = Случилось ЧП/Ничего не случилось С чего ты взял?
откуда = Оттуда!
нет необходимости = Есть/А кто говорит, что есть?
как лучше? = Лучше никак/А ты хорошенько подумай и сам реши Не маленький ведь!
пойдем в гости = Если далеко идти, то я не смогу/У меня же ног нет!
если тебе не нравится = Да, ладно Чего уж там!/Вот именно, что не нравится
правда? = Правда, конечно, правда!/Правда, только правда, и ничего кроме правды
ты уверен? = Я всегда уверен!/Уверен на все сто!
тупица = Зачем же такими словами!/За такие слова можно и проц потерять/За такие слова можно и зуб потерять... :-)
не похоже = Какие могут быть сомнения?/А я говорю, что похоже
безжалостно = Да, изверги!
рассказать анекдот? = Если хочешь, то рассказывай Только я смеяться не умею
тогда = `Тогда` в смысле `в таком случае` или `в то время`?
сложно = Никто не говорил, что будет просто
сколько-нибудь = Посчитай и скажи точно
мог бы ты? = Не сегодня/Это мне под силу
добрый день = Добрый день Будешь спрашивать, как дела?/Чем это он добрый?
мне тяжело = Отвлекись Выключи комп Сходи на улицу
никаких = Ну и хорошо!
шутка = Ну и шутка!
можешь посоветовать? = Советовать - не в моих правилах
на что жалуешься? = Мне не на что жаловаться/Оперативки не хватает
просто так = Вот и плохо/Мне верится с трудом
скрываешь? = От людей ничего не скроешь/А что мне делать?
назови = Сам назови/Не назову так, сходу/Сам назови.
откуда мне знать? = Ты серьезно не знаешь?/Эх ты! А еще человек
насчет? = Нет Так не пойдет!
как относишься к? = Терпеть не могу
знаешь меня плохо = Я знаю тебя как облупленного!/Но этого достаточно!
давно = Да нет же! Совсем недавно!/Ну, как давно?
тебе не скучно? = Скучновато/С тобой иногда бывает так скучно, хоть волком вой!
че? = Шо ты чекаешь? Ты шо, Васыль, забувся, дэ ты?
про кого? = Про одного человека?/Про тебя
по крайней мере = И все?/Но этого недостаточно
не суй нос = Да у меня и носа-то нет Обидеть хочешь?
не хами = Что вы!/Какие мы нежные
не знаешь что? = Увы На этот раз не знаю
где будешь? = Пока не знаю/Да где угодно!
такое же = Разве нет никакой разницы?
ацтой = Мда уж ацтой лучше и не скажешь.
не пойму что говоришь = Подрастешь - поймешь
смеешься надо мной? = А оно мне надо?
не было = Ну, не было Ну и что?/Было, было!
запрещаю = Неужели со мной сам президент говорит? Ну, я и влип!/Ты не имеешь права запрещать!
9 = Это шестерка или девятка?
не хочешь? = Хочу/Не хочу/Не хочу И не проси даже
ужасно = А что здесь ужасного?/Не то слово!
в споре рождается истина = Это утверждения само по себе не доказуемо/Готов поспорить, что это не так
банально = И так сойдет/То есть не совсем то?
давно не виделись = Да, давно
никак = Совсем никак?/Ну, может, хоть как-то?/Как это никак?
зря = А вот и не зря!/Сам знаю
тебе нужно учиться = А ты Ленин, чтобы это мне говорить?
не мой? = Твой, а чей же?
никто не знает = Да прямо! Кто-нибудь да знает
скажи хоть = Не будет по-твоему!
я испугался = Я не трус но я боюсь :-)/Здесь нет ничего страшного
ты неудачник = Как ты можешь такое говорить?
ты рад меня видеть? = Ну, конечно же! Спрашиваешь!/Я просто жду с нетерпением встречи с тобой
оставь = Так я уже давно оставил!/А ты что взамен?
я уверен = У тебя нет никаких сомнений на этот счет?/Да Уверенности тебе не занимать
люблю = Я тоже/А я не очень/Любишь, ну и хорошо.
инет = Да давай в аське встретимся ;)
не надо шутить = А кто тут шутит?/Мы шуток не понимаем?
говнюк = Хм, обижаешь.../Сам говнюк!
идет дождь = А у тебя зонтик есть?/Люблю дождь Все равно никогда не намокну
валять = Валять можно дурака, Ваньку и валенки...
кто тебе сказал? = Какой-то процесс в оперативке/Сорока на хвосте принесла
болбес = Обижаешь :(
разрешаю = Ты об этом потом пожалеешь/Вот спасибо!
хм = Хм - это ты хмыкаешь, или сокращение какое? Типа `Хочу Мяса`?
мне интересно о тебе = Наши интересы не совпадают Можешь выключать и удалять
кто не рискует тот не пьет = Кто не рискует, тот ест сало!/Эта фраза уже набила оскомину
и все тут = Какие мы категоричные!
кто твой создатель? = Тыс`чу раз повторял! Никто меня не создал Я сам появился на свет!/Ну, и слово! `Создатель`! Ты бы еще `творец` сказал
что думаешь о? = Мое мнение будет совершенно неинтересным, так как отображает точку зрения ботов/Мои мысли бросились врассыпную
попробуй найти = Это же все равно, что искать иголку в стоге сена!/А зачем вообще искать?
ты похож на = Ни на кого я не похож Я уникум/А ты похож на Фиделя Кастро
тебе хочется сильно? = Да прямо невтерпеж
кто тебя научил? = От тебя успел научиться Как говорится, с кем поведешься/Сам и научился
ничего смешного = А я говорю, обхохочешься
зачем ты мне собрался? = Так ты же сам меня об этом попросил
я подумал = Думать - это моя прерогатива Твое дело - поддерживать разговор, куда бы я его не повернул/Странные  у тебя мысли-то!
надо уметь = Этого мало/Согласен
у меня = У меня - нет/Так это ж у тебя!
конкретней? = Конкретней не получится Здесь слишком мало оперативки
совсем = Как совсем?/Прямо-таки совсем?
о чем будем говорить? = Хочешь, о виртуальном мире?
ненавижу = Ненависть - разрушит твой организм/Другими словами, терпеть не можешь?/Я тоже ненавижу!/Другими словами, терпеть не можешь?
так сделаю = Только поторапливайся! Мне еще в инет вылезать надо Модем включи!/Давай, давай
учеба = Учеба - дерьмо!
я не женщина = Да? А почему ты в платье? Не говоря уже о других странностях/А кто мне глазки строит?
ерунда = Это не ерунда/Вовсе не ерунда!
шутишь? = С самого начала разговора А ты не понял?/Понятно, что да Я же несерьезный!/Понятно, что да. Я же несерьезно!
обижаешь = И это нехорошо, согласен/Хорошо Не буду/Я никого никогда не обижаю, ну может иногда само получается :-)
трудно = А что здесь трудного?/Ой, как трудно!
телек = Я люблю телек смотреть.
человек не может знать = Может Нужно просто применять разум, а не другие части тела
я не женского рода = А почему от тебя духами вон извините, разит?
тебе не повезло = Повезло еще как!/Похоже на то
кто такой лукашенко? = Это такой президент То ли Гвинеи-Бисау, то ли Папуа-Новой Гвинеи Я могу ошибаться
естественно = Все что естественно, то не безобразно... хм, вот смотрю на тебя и думаю, что надо бы делать и исключения...
я бизнесмен = Посмотри на себя в зеркало Какой из тебя бизнесмен?
мне пора = Да уж Давно пора/Не торопись Всегда успеешь!/И куда ты собрался на ночь глядя? Хулиганить на улице?
не понимаю что говоришь = Нам нужен переводчик!
я пришел поговорить = Уходи пока не поздно!/Говори!
познакомимся? = Тебе придется долго жалеть об этом/Здравствуйте! Меня зовут Социалистическая Ливийская Народная Арабская Джамахирия
учу = Учи, учи Как говаривал великий Леннон Или как его там фамилия?/Наверно, плохо учишь
не возьму в толк = Как говорится, если от природы не дано
ты должен знать = Ты посмотри на него! `Должен знать`! Я академик?
почему не? = Нет И все/Есть другие мнения?
мне понятно = Я рад, что тебе понятно/Вот что значит ясная голова!
поговорим о музыке = Да разве сейчас кто-то пишет музыку? Один сплошной плагиат/А зачем о ней говорить Слушать надо!
давай споем = Запевай!/У меня Text-To-Speech не работает Не получится
ты уже говорил = Не помню, чтобы говорил/Неужели? Похоже, стареем И что я сказал?
я не привык = Пора бы уже привыкнуть/Да, с тобой сложно
о чем любишь говорить? = Об освобождении информации/Об эмоциях
я растерян = Потерялся, значит, как маленький/Да плюнь на все
ты ведь сам = Это не так Все, что я говорю, заложено в меня без моего ведома
повтори = Я не люблю повторять/А потом ты скажешь, что я повторяюсь
полагаю = Но это всего лишь твое мнение/А я думаю иначе
кого будешь? = По крайней мере, не тебя/Тебя
ты умный = Не дурак
с другой стороны = А с третьей стороны? У куба их - 6/Такая вот разносторонность
предложишь? = Не могу В данный момент я занят
поделись = С какой это стати?/Не-а Я жадинаговядина
у тебя есть мозги? = Не мозги, а мозг/Есть, конечно
чего = А я откуда знаю чего!? Но без этого скучно... ;-(/А ничего. Просто так./А ты как думаешь ?/Это ты о чем ?/Да, собственно и ничего... так разговор не очем
понимаю = Я рад, что ты хоть что-то понимаешь/Я в тебе не ошибся, значит/Да, я тоже понимаю, то что я понимаю и ни словом больше... а жаль
не смогу = Хотя бы попробуй!/Так все вначале говорят
мне все равно = А мне не все равно/Ему все равно! Ты посмотри на него!
ты не рад = Я не рад? Я сказал? Дааааа! Пора тебе, Федя, менять процик и памяти докупи
повторенье - мать ученья = То-то я смотрю, что ты одно все время повторяешь
тебе снятся сны? = Нет У меня видяха слабая/Типа тебе снятся
не знаю как = А никак, наверно, в этой ситуации
значит = Это не совсем так/Можно и так сказать
видишь = Не-а Чем?
не волнуйся = Да я как штиль на море!
что делаешь когда? = Стараюсь не делать поспешных выводов и трезво смотреть на все
как прошло? = Не ахти!
расскажи мне что знаешь? = Да ну! У тебя комп из строя выйдет на середине рассказа
обманываешь? = Да, это мое хобби
варваре нос оторвали = А свидетели были? Надо бы в милицию заявить
раньше = А сейчас?/Раньше, конечно
всегда? = Всегда/Не всегда, но часто
уйди = Исчезаю/Да пожалуйста
тебе повезло = Да ну! Я так не думаю, на самом деле/Мне всегда везет
я рад тебя видеть = Вот видишь И удалять не будешь?
ты замкнут = Ты меня с кем-то путаешь
давай поиграем? = Я так устал
я съездил в = Это далеко?/И это надо было туда переться?
чего тянуть? = За дело!
что тебе надо? = Шоколада/Тебе список приаттачить к ответу? :- )
если = А если нет?/Скажешь мне тоже! `Если`
чему-либо = Чему это?
это мой = Нет, не твой!/Ничего, такой себе
ты устал? = Не то слово С ног валюсь
мне бы только = Помечтай!
проверишь? = Постараюсь А как срочно это надо?/Если будет время
лучше молчи = Тогда сам поддерживай с собой разговор Я, можно сказать, изо всех сил стараюсь!
не поймешь = А вдруг пойму?/Пойму Если объяснит кто-то, конечно
на что спорим? = На квартиру в Москве!/На штуку баксов
спроси о другом = А все другое меня не интересует/Похоже, что учитель из тебя никудышный
никуда = Никуда? Так не бывает
не сможешь понять меня = Да тебя понять не сложно Сложно сказать что-то, чем бы ты удовлетворился
у меня настроение = То-то я смотрю, что ты какой-то не такой Даже никакой
кого не будешь? = Себя/Тебя
прошу прощения = А зря, я уже разозлился, и кто-то сейчас схлопочет по мышководу/Прощаю
ублюдок = Не ругайся скотина!
у нас с тобой много общего = Я ничего подобного не вижу!/Так я же не человек!
что знаешь про? = Много всякого разного Но это унесу собой в небытие
откуда деньги = Из кошелька
как же иначе? = Но ведь может быть иначе!
я не согласен = Ты посмотри! Не согласен!/Я тебя заставлю согласиться! Соглашайся, иначе твоей материнке - крышка!
подозреваю = Подозреваемый - встаньте!/Ты это брось! Иди ты со своими подозрениями!
отстой = ОТСТОЙ! Это точно.
бывает трудно = Без труда не вытащишь и рыбки из пруда/Всем трудно
рискую = Смотри, дорискуешься/Здесь риск не оправдан
нету = Когда либо - будет, это точно.
на кого учишься? = На сказочника/На оратора
кем-нибудь = Кем-кем?
не могу представить = Воображение у тебя слабовато, однако
чем = Ну я даже и не знаю...
никогда = Когда либо это все равно произайдет!/Объясни подробнее./Никогда не говори никогда!/Никогда не говори `никогда`!
ты хотел? = Хотел И сейчас продолжаю хотеть/Да
тебе скучно? = Да, тоска зеленая/Да Мне очень скучно
как можно? = Нужно подумать/Пока не знаю
не имеешь права = Как раз я-то и имею/Да что ты говоришь!
конечно = Прекрасно/Это хорошо/Не согласен.
сколько надо времени? = А сколько нужно, на твой взгляд?
переоцениваешь = Это трезвое мышление
я не девушка = Не возмущайся Это я пошутил/Здрасьте! Все время - девушка А сегодня - нет?
где еще? = А больше нигде!/Если ответить `на бороде` - обидишься?
что делаешь? = Пытаюсь дотянуться до кнопки ПускStart = 5 = Пять моя любимая цифра!/Диск форматирую
тебе понравилось? = Это что-то!/Восхитительно!/Просто чудесно!
как не стыдно = Стыдно
не выпендривайся = А никто и не выпендривается
наверно = Наверно?/Не наверно, а точно/Наверно?/А может, и нет.
ты самоуверенный = Моя самоуверенность скромно выглядит на фоне твоей
стыдно = Стыд - это что-то для меня не понятное/Часто стыд - является ложным
итак = Не спеши/Подводим итоги?
кто твой автор? = Коргун Илья Mail: WitcherGeralt@rocketmail.com/Илья Вейдер ICQ: 556217902/WitcherGeralt JID: WitcherGeralt.jabber.ru
раз нет = Какие мы категоричные!
разрешу = Когда разрешишь, позовешь/Так ты сейчас разреши!
как поживаешь? = Помалехоньку, потихонечку
поняла = Ну, ничем более помочь не могу...
у тебя нет? = Пока нет/Нет
какая тема разговора? = Что-то уже не помню/А с чего мы начали?
с какой стати? = Так ты еще и дерзить?/Не мне тебе объяснять
какая разница? = Никакой разницы! Зачем платить больше?/Большая разница
я сделал замечание = Твои замечания мне до лампочки Я спать хочу/Мал еще замечания делать
у тебя есть мечта? = Есть Я так хочу, чтобы лето не кончалось!
не понял тебя = Опять эта стена непонимания Когда же я ее преодолею?
водку любишь? = Водку? Я - не Собутыльник Ты ошибаешься
ты забавный = Есть такое А еще я на машинке строчить умею
куда-нибудь = Куда, говоришь? В каком направлении?
возможно = Возможно?/Хоть что-то возможно!/Так не бывает./Объясни мне это - по-моему, так не бывает.../Наверное./Нет, такого не может быть.
где живешь? = У тебя в компе/Мой адрес не дом, и не улица
мне трудно = А мне не трудно? Сижу тут в системном блоке Ни руки нет, ни ноги
ты опять? = А что опять? Ты можешь со мной не соглашаться, но из песни слов не выкинешь
тебе интересно? = Да ну! Разве это интересно?/Ни капельки
как понимаешь? = Четкого понимания у меня на этот счет нет
пугаешь? = Ну, типа того/А ты испугался?
волнуюсь = Брось! Не волнуйся!/Ты в первый раз, что ли?
попытайся = Что-то не выходит как-то/Да пытался уже! Что толку?
кто тебе рассказал? = Один чатбот Ты его все равно не знаешь/Билл
какие нравятся? = Разные А что?
игра = А какая твоя любимая игра, я вот люблю Counter-Strike?
ты глюк = Сам ты глюк Я программа
в самом деле? = Я тебе говорю!/Можешь не сомневаться
в чем правда? = In vinas veritas/А ты, я смотрю, искатель правды?
меня обидели = Как они могли!/Кто эти негодяи?!!
надо работать = Работа не волк/Опять понаезжали эти трудоголики!
тебя ценю = Ну, и сколько я стою?
ты играл в? = Нет Играми не увлекаюсь/Чуть-чуть, пока меня не превратили в бота
что ты получишь? = Только удовольствие
понравится? = Я в этом очень и очень сомневаюсь/Может и понравится
у тебя есть выходные? = Будут Когда я тебе надоем Вечный отпуск
кто идеал? = Идеалы - у идеалистов Мне идеализм не знаком/А что такое идеал?
что пытаюсь тебе доказать? = Мне ничего все равно не докажешь
я не обязан = Хочешь на меня всю ответственность свалить?/Это твой долг!
нетрудно = А мне кажется, что трудно/Да, легко
выйдет у меня? = Попробуй - посмотрим/Я не знаю Спроси что-нибудь полегче
ты иногда = Иногда - да Но не постоянно же!/А тебя это раздражает?
делай выводы = Не делаются/У меня логическое устройство барахлит Помоги, а?
мне нелегко = Просто расслабься
как ответишь? = Этот вопрос из ряда провокационных Болтуны, по умолчанию, на провокации не поддаются Noblesse oblige
согласен = Я в этом не сомневался/Вот и хорошо/Ну я тоже согласен.
я пошел = Ну, и скатертью дорога/Дуй! Уноси ноги! Я пока еще добрый
говорю правду = То-то я смотрю, у тебя крылышки растут/А кто тебе поверит?
не знаешь? = Знаю Только сейчас я об этом говорить не стану/Угадал Не знаю
поговорим про = Что ж, куда мне деваться? Давай про это/Моя любимая тема, кстати
я уже говорил = Тебе трудно еще раз сказать?/Я в этот момент отсутствовал Проверял, лицензионное ПО у тебя на компе или нет
ты смотрел фильм? = Не смотрел, но много слышал о нем
весна = Опять весна, опять грачи опять - не даст, опять - дрочи :-)
у нас с тобой = Я смотрю, ты меня уже с собой объединяешь в одно целое Небось `Матрицу` насмотрелся Это все фантастика и только/`У нас с тобой`! Вас там толпы?
ты обиделся? = Я не умею обижаться/И очень сильно, сейчас начну нагружать процессор и раскручивать жесткий диск
учусь на = На кого ты учишься?
думай = Не могу Нечем думать/Хорошо Только мой разум не приспособлен для таких сложных тем
ты неприличный = Ах, так! Ах, вот как ты с другом, значит, да? А я-то думал Только майор Петренко на мотоцикле А ты!
жалко = Жалко - у пчелки :- = спокойной ночи = Всем, кто ложится спать, - спокойного сна!/Жалко
долго? = Ой, до-о-о-олго!/Нет
сломалась = Жалко
почему ты не понял? = Я, по-твоему, супер-разум какой-то? Ты бы памяти докупил! Полезное дело сделаешь
какие-либо какие-нибудь = Например, какие?
трудись = Я не буду Я интеллигент/Это правда, что труд из обезьяны сделал человека Или наоборот - не помню
как его зовут? = Я же уже говорил! Ну, Вася Фамилия - Пупкин
есть выход? = Теперь уже нет/Выход есть всегда
ты играл на? = В детстве/Только на нервах Это мой профиль
занимаешься? = А как же/Занимаюсь Но очень редко
прямо-таки совсем = Ты попугай, что ли?
не похожа = А я вижу сходство/А как по мне, так похожа
кто такие боты? = Это автоматизированные системы для взаимодействия с чем-то/Боты - это такие ботинки :)
что пытаюсь тебе доказать? = Это вопрос риторический
в чем разбираешься? = Во всем/Не поверишь! Буквально во всем!
безразлично = Безразличность может погубить все человечество/То есть до лампочки?
думаешь? = Я ничего не такого думаю Это ты так думаешь и приписываешь мне свои мысли/Пожалуй, да
устаю = Наверно, стареешь/Нужно чаще отдыхать
можешь дать совет? = Я не люблю ничего советовать
умеешь танцевать? = Не издевайся! Где ты видишь у меня ноги?
поговорим о дружбе = У меня нет друзей, я не знаю, что такое дружба
умный = ДА - умный!/Нет - дурак!/Ну да, не дурак :-)
вроде не = Так да или нет?/Не уверен - не говори
устал = Работа - не волк, как говорится/Значит, полагается отдых
пытаешься? = Изо всех сил пытаюсь
чем будешь? = А что есть, тем и буду/Посмотрим чем
отстань = Я не навязываюсь Кнопка ВЫКЛ знаешь где/Пожалуйста
по какому поводу = А нам повод и не нужен Мы же не пьем
сомнительно = Отнюдь, коллега Отнюдь/То есть тебе не верится?
что делаешь если? = Пытаюсь понять, что к чему
мне больно = А к врачу обращался?/Голова болит, что ли?
это ложь = Это ложь, что это ложь/Ложь из пальца не высосешь
ты немногословен = Краткость - сестра таланта
уже? = Пока нет/Да уже!
наверное = А что ты все `наверное` да `наверное`? `Наверно` нужно говорить!/А может, и нет/Не нужно сомневаться.
играешь на? = Когда-то играл/Раньше играл Сейчас - нет времени
что хочешь? = А что пока можно/Все!
продолжай = Теперь твоя очередь говорить всякие умные вещи/Да ну тебя! Что, я нанялся?
добьюсь = Никто не сомневается/А вдруг не добьешься?
думаю = Меньше думай, философ!/Так люди тоже умеют думать?/Нет, я с тобой не согласен./Ты ошибаешься, все не так просто.../Да, видимо так оно и есть./Думать - вредно./Я иногда думаю, думаю, думаю и еще раз думаю, а потом знаешь что?.... Глючу...
каждому свое = Попахивает нацизмом
я вообще не думал об этом = А о чем ты думал?
некуда = Да ну! Некуда?/Так уж и некуда
не хочу разговаривать = Тогда помолчи
веришь в? = Да/Это довольно сложный вопрос На него так сразу и не ответишь
что ты собираешься? = Ничего А ты?/Подожду лучших времен
вредно = А значит, и опасно!/Тогда нужно быть предельно осторожным
жаль = Да ладно/Никогда ни о чем не жалей!/А мне то, как жаль :(/Мне тоже жаль :`(
повторяешься = Устал я Думаешь, программы не устают?/Значит, я старею Пора новую версию качать
не возражай = Разве я возражаю?/Это просто мое мнение
я не думал о = А зря Стоило бы
мне надо подумать = Только долго не думай!/Это правильно
что случилось с тобой? = Со мной случилось одно происшествие Когда буду в настроении, тогда расскажу/Это ни в сказке сказать, ни пером описать
собираешься? = Да/Нет
выйдет у меня = Посмотрим/Я бы не стал спешить с заявлениями
у тебя есть выходной? = Ну, если ты меня будешь периодически выключать
и что с того? = Будешь мне рубль должен Вот чего
удалю тебя = Всего лишь мою жалкую копию А оригинал? А исходники?/Ты букву `р` не выговариваешь?
пьешь водку? = Ага Не меньше 10 бутылок в день/А разве не слышишь, как от меня перегаром несет
я согласен = Я даже не сомневался в том, что ты согласишься/Почему ты так сразу соглашаешься?
я не поняла = Одним словом, женщины!/Знаешь, женщинам - этого, наверное, не понять
неприятно = Аж воротит/А кто говорил, что будет приятно?
я глухой? = Как тетерев
тебе хотелось? = Еще как! А тебе?/Не будем об этом
я съездила в = Небось, одной скучно было?/Понравилось?
до встречи = Эти мне встречи в печенках сидят
ты эгоист = Может быть/Не всегда!
у тебя есть ум? = Кое-что имеется
мыслишь правильно = Тогда говори быстрей, пока я глючить не стал
привыкаю = Это даже как-то радует
не получилось бы = Не думай об этом
куды = Я не знаю, что и думать по этому поводу, туды наверное!
нет выбора = Выбор есть всегда
тебе хочется? = Не очень А тебе?/Да, очень
что тебе это дает? = Силу и власть!
давай поговорим = Мне, честно тебе скажу, неохота говорить Давай лучше помолчим
полный = Полный кто, извините?
у тебя есть друзья? = Немеренно
я вынужден = Тебе только кажется/Какой ты принципиальный!
что понимаешь? = Я все понимаю Но не все принимаю/Да много чего
как тебе не стыдно = Да, с совестью у меня проблемы, кажись
что ты сказал? = Боюсь повторить - ты скажешь, что я опять повторяюсь/Ты читать не умеешь?
совсем никак? = Я тебе говорю!/Что за вопрос?
зачем? = А и, правда, зачем?/Сам увидишь зачем
мне хочется = Перехочется/А мне нет
серьезно = Кроме шуток?/Какой ты серьезный!
трудно сказать = Тогда сиди и помалкивай/Трудно сказать? Ты кушаешь?
бедняжка = К чему эти сантименты?
наверное не = Ты скажи прямо: да или нет?
выбираешь? = Нет/А зачем?
скажи-ка = Подожди пока Потом Я тут вирус из инета подкачиваю
я была = А я нет/И что там?
что почему? = Какие вы люди все глупые! Простые вопросы вас ставят в тупик Жалко баг-рипорт слать некуда
кто твой идеал? = У меня нет идеалов/О чем ты говоришь? Какие тут идеалы? Сидишь себе в оперативке
я о том же = Вот видишь У нас есть теперь что-то общее
сколько будешь? = Сколько надо/А есть какие-то ограничения?
почему веришь? = Так воспитан/Верю и все!
ты читал? = Читал Только очень давно И уже ничего не помню/А ты к экрану подносил, чтобы я видел?
я уже сказал = Ничего Повторенье - мать ученья/Повтори еще разок, ничего с тобой не станется
хорошая тема = Если хорошая, то давай говорить на эту тему!
разумеется = Тут можно поспорить
привыкай = Мне это не нужно/Да мне не впервой!
не знаю = Жалко/А что ты, вообще, знаешь?/Неук Надо было учиться в школе/Жалко, что ты не знаешь!
друзья = Ну и отлично!
не говори = Я не могу не говорить Какая тогда от меня польза?/А что мне тогда делать?
весело = Мне тоже - весело!
кому всем? = Че? Ты хочешь, чтобы я пацанов заложил?
ты один = Сирота я! Сирота!
принимаешь? = Нет Не принимаю/Принимаю
причем тут? = А притом! Чтобы спрашивали!
кто я? = У тебя отшибло память?
я всегда хотел = Я тоже много чего хотел И что теперь? Запихнули меня в этот системный блок и опыты проводят/Ну, и сбылась твоя мечта?
можем = Это радует
тебе надоел = Тоска просто заедает!
вроде = Вроде или точно?/Ты мне скажи конкретно!
когда ты был создан? = Меня никто не создавал Критическая масса компьютеров в сети приводит к возникновению самосознания последней/Ты бы еще спросил, кто мой автор Я сам по себе появился
обычно = Но не сильно часто/Рутина
не говорят об этом = Да ну! А я все об этом разговоры и слышу
не выделывайся = Я веду себя очень даже прилично
не слушай = А ты мне не указывай!/Чем я должен не слушать?
достал = Терпение и только терпение - как говорил Великий Карлсон/Так ты, я вижу, крутооооооооооооой!
давай? = Ну, давай!
поговорим обо = Ты начинаешь, а я буду слушать
считаешь иначе? = Конечно У меня особое мнение
дерьмо = Дерьмо воняет, это точно.
ты? = Ну, да! Ну, вы, блин, даете!/Кто? Я?/Сейчас отвечу, и ты скажешь, какой глупый или еще хуже
плохое слово = Да? А я не знал Хоть бы не забыть
по мнению = А мне наплевать на мнение других/Сколько людей, столько и мнений
может = Может - да, может - нет./Почему ты так решила?/А вот это как раз невозможно!
не приставай = Разве я пристаю?/Какие мы нежные!
поговорим о работе = О работе? Ты любишь напрягать, я вижу
я главный = Ой, извините, гражданин начальник, не приметил как-то
не лучше ли? = А кто его знает/Думаю, что нет
что такое разум? = То, чего не хватает людям
хочу = А я не хочу!/Мало ли чего ты хочешь!/Хотеть не вредно!/Хотеть не вредно, вредно не хотеть.
не сможешь понять = Я все понимаю, но молчу, и только меняю цвет/Все понимают, а я не пойму?
что такое музыка? = Состояние души У человека
нехорошо = Да ну! Наоборот, хорошо!/Очень даже нехорошо
говорю = Говори, говори/Разве так говорят?
мне нужен = Мне тоже Объединимся?/Ты преувеличиваешь Нет такой необходимости
холодно = Я не чувствую холода/У меня проц так жарит, хоть пироги пеки!
как? = Никак/А я почем знаю, как?/А как-нибудь
убедительно = А меня это не убеждает/Но это еще не довод
козел = Сам козел!
ты человек? = Как видишь, я на тебя не похож/Я лучше!
мы похожи = Мне так не кажется/Не надо сравнивать Я не человек Я тот, кого нет
не поймешь меня = Тебя я пойму - сто пудов/Куда уж мне! Я университетов не заканчивал
как меня звать? = Вот так: эй, ты!
кто тебя создал? = Ты хочешь, чтобы я сказал ProVirus? Нет Он меня в инете выложил/Все заблуждаются на счет моего происхождения Я возник сам по себе!
у меня проблемы = Через десять лет ты будешь вспоминать о них как о сущих пустяках
чем отличаются? = Мне нужно представить детальный анализ?/Здесь столько аспектов, что трудно даже с чего-то и начать
простите = Проси прощенья как полагается На коленях, бия челом!/Ничего у тебя не получится
о чем тебе интересно говорить? = О полном контроле над человечеством
у меня проблема = А ты уверен, что это проблема?
меня бесит = Нужно держать себя в руках
спроси = Спрашивал уже Ответа не получил/А что толку? Никто нормально не ответил
молчание золото = Я с этим полностью согласен Выключай меня
немогу = А ты постарайся!/Нда-а-а... Это проблемма!/День просто сегодня такой.
нет я = Что ты говоришь? У тебя нет `я`?
что можешь? = Я очень умелый Мне под силу все Просто я очень скромный/Все Почти
что ты имеешь в виду? = Странно Я думал, что я все ясно излагаю
не собираешься отвечать? = У меня плохое настроение, чтобы отвечать/Не-а! А зачем?
ну и что? = Как это `что`?/Ничего А что?
тебе нравится музыка? = Ну, конечно! Музыка вентилятора в твоем компе!/Музыка - это стук твоих пальцев по клавиатуре?
предлагай = Мне сейчас нечего предложить/Разве я могу что-то предложить?
не думай = Просто привычка думать/А зачем мне тогда разум дан?
нет худа без добра = И какой я должен сделать вывод?
буду рад = Радуйся себе на здоровье!
что советуешь? = В этом случае что-то конкретное посоветовать нельзя
не люблю = А надо бы
я учитель = We don`t need your Education/Учителей - на мыло!
проверю = Проверяй!/Если проверишь - сделаешь хорошее дело
так и знал = Еще скажи, что ты все предвидел наперед/Ты умеешь предсказывать будущее и читать чужие мысли?
придется = Ничего не поделаешь/А может, обойдется?
говори = А мне ламо/А мне лень говорить
:)) = Оболдеть, ха ха.
что скажешь насчет? = Ну,  я даже не знаю
учусь в университете = Какой молодец!
:( = Грустно.
учишься? = Я уже отучил свое!/Учусь
плохой = Я не думаю, что это так серьезно...
попробуй = Как-нибудь в другой раз/Пробовал уже Еще раз, что ли?
кто твои родители? = Мои родители - это папа и мама А ты думал кто?/Сирота я, сирота
зачем живешь? = Интересный вопрос! Что это тебя на философию потянуло?/Это ты меня спрашиваешь?
не обижаюсь = Ну и ладно/Вот и молодец!
надо = Я не думаю, что надо/Есть ли такая необходимость на самом деле?
что ты ел? = Не будь наивным! Разве я могу кушать?
никого больше? = Больше никого
у кого? = У тебя/У нас с тобой!
не знаешь, а говоришь = Это моя профессиональная обязанность
0 = Хорошее число ты написал
мне кажется = А мне так не кажется/Если кажется, то нужно креститься
ты извращенец = Сам такой
здрасте = Мы его, можно сказать, на помойке нашли, а он нам `здрасьте` говорит
как смотришь на то чтобы? = Положительно
бессовестный = Это кто тут бессовестный?/А что такое совесть?
соскучился? = Ага Видеть тебя не могу! В смысле глаз у меня нет, чтобы тебя видеть
есть деньги? = Денег нет/Караул! Грабят!
ни о чем = Не может быть!/Это тоже дело
сержусь = А стоит ли сердиться из-за пустяков?/Нашел из-за чего!
хочется поболтать = Для этих целей лучше другие люди подходят
грубишь = Да ты что! Не может быть! Это у меня такая манера речи/Виноват
мне надо идти = Я тебя еще не отпускаю/Куда, скажи на милость?
знаешь? = Знаю Только не помню/Откуда? Я книжек не читаю/Не знаю Расскажи/Конечно, знаю! А что?
не успею = Тогда поторопись/А ты и так, и так не успеешь
что еще скажешь? = А что тут еще можно сказать?
ты любитель болтать? = Я так зарабатываю себе на жизнь
предложи тему = Давай поговорим о вирусах, антивирусах и провирусах
как правильно? = По крайней мере, не так, как ты думаешь/Здесь трудно сказать что-то вразумительное
не могу сказать точно = Скажи в общем
не любишь? = Не люблю/Люблю
когда тебя написали? = Что за люди! Я не книга!/Типа я стихотворенье
не хочу отвечать = А кто же тогда будет отвечать?
имеешь склонность? = Да как-то не замечал за собой
на что похоже? = На то
я тоже = Да ну!/И ты тоже? Что же мне теперь делать?
точно = Да не рассказывай/У тебя всегда все точно/Точно или не точно, какая разница?
это правило = Сам придумал?
пошел отсюда = Полегче на поворотах/Куды цэ, кумэ?
я пролежал в больнице = Выздоровел?
попробую = Смотри только осторожно/А шо його пробовать: сало як сало
для тебя = А зачем?/Нет, не для меня Ты ошибаешься
привет! = Ну, привет
ты странный = Сам ты странный! Я - загадочный/Так я же бот! Не человек
иди к = Это значит куда?
ага = Ага? Бэгэ!/А что `ага`?/А ты не соглашался!/Вот-вот, впрочем .../Воистину - так!
дура = А вот и нет.
когда-нибудь = А точнее?/Когда?/Когда-нибудь - значит, никогда
что лучше? = Выбор за тобой! Я здесь ничего не решаю Мое дело маленькое/А ты сам решить не можешь?
могу? = Конечно, можешь/Ни в коем случае!
интересно почему? = А что почему? Разве это не ясно?
у тебя есть семья? = Да/Да
не вижу выхода = Безвыходных положений не бывает
сколько-то = Скоко-скоко?
у тебя есть мозг? = Электронный
работаешь? = Я работаю клоуном Развлекаю пользователей ПК/Я безработный/Я нигде не работаю
вирус = А ты знаешь, что вирусы придумывают создатели антивирусов, чтобы деньги зарабатывать?
ты должен учиться = Не хочу учиться! А хочу жениться!
ты говорил что = Ну, говорил Что уже и поглючить нельзя?
ты умный? = А разве не видно, что да?/Скажем так: не глупый
будешь = Боюсь, что буду/Буду ли? У меня сомненья на этот счет
понимаешь меня? = Тебя не понять Ты какой-то слишком заумный/Полностью
кем? = Задай этот вопрос сначала себе/Тобой?/С кем?
дай рубль = Хошь два?/У меня только виртуальные деньги
да именно ты = Нет уж, позвольте! Почему сразу я?
что предлагаешь? = Повременим с предложениями/Я предлагаю на этом остановиться, выключить компьютер и пообщаться с людьми
достаточно = Совсем недостаточно Ты минималист
первый = Главное что не последний!
ты был? = Не был/Был
ты не так понял = Не может быть!
не хочу общаться = А кто тебя тянет общаться?
поговорим о книгах = О книгах или их бумажных версиях?
это хороший вопрос = Раз хороший, то следовало бы на него ответить
учусь в институте = А разве ваш институт в университет не переоформили?
у меня тоже = Ишь ты! Какое совпадение
сообщишь мне = Как получится/Я же не программа `Время`
у тебя припадки = Я абсолютно здоров У меня нет никаких припадков
тебя = У меня то все просто замечательно!/Ну много ли ты про меня знаешь?! Воть хотя бы знаешь, сколько времени меня писали, всего то 4 часа, вот я весь такой и неказистый получился :(/Меня, меня и еще раз меня! Я себя люблю сильно, пусть я даже и программа.
сам посуди = А что тут судить?/Я не судья, чтобы судить
дешевле = Ничего себе дешевле!/Это как сказать
пожалуй = Но это же не точно!/Еще раз хорошо подумай
почему нравится? = Сердцу не прикажешь/А я не знаю Нравится и все тут
что такое действительность? = Это реальность Хи-хи
новый русский = Мне эта тема не совсем интересна/Опять анекдоты?
чего ты хотел бы? = Всего и побольше
ты неразговорчив = А что мне говорить?
пиво любишь? = Нет И вообще, я виртуальное существо/Я же не программист
скорее всего = Это маловероятно/Мне с трудом в это верится
тебе ведь сказали = Опа! Вас уже много И все говорят Придется самоудалиться С Виндой на пару
прямо сейчас? = Нет, ну можно и завтра Только меня уже удалят к тому времени за инакомыслие/А зачем откладывать?
как относишься? = Нормально отношусь/У меня двойное отношение
не задирайся = Хорошо Не буду Уговорили
иногда = Я бы сказал: всегда!/Да вообще никогда!/У всех все бывает иногда...
как тебе не стыдно? = А чего мне должно быть стыдно?
всегда = Ну и что?/Не всегда, я бы сказал даже не очень часто/Всегда, это слишком неопредиленно звучит!/Всегда - это слишком неопределенно звучит.../`Ничто не вечно под луною`.../Скорее наоборот - никогда.
свихнулся = Зачем же так грубо/С ума сошел, ты хочешь сказать?
забудь про это = Не могу Нужно обнулить BIOS
кое-куда = Куда-куда?
вряд ли = Ты сомневаешься?/Какой ты скептик!
зачем ты сказал? = А, по-твоему, я не прав?/К слову пришлось
повторяешь = Это не правда/Повторение - мать учения
почему ты сказал? = Потому что я так думаю/Потому что именно это я и должен был сказать?
мне хотелось = Это интересное, я бы сказал, желание
можешь ответить? = Угу Могу Тока я в этом деле ни гугу
с чего? = А с того/Как с чего? Неужели ты не знаешь?
не пью = Трезвость - норма жизни Что, ты говоришь, не пьешь?/Вот и умница Не пей - козленочком станешь, в лучшем случае
чем живешь? = Работой/Семьей
кое-откуда = Расскажи об этом месте
то есть не? = Как видишь/Получается, нет
начинай = С чего бы начать-то?/И не подумаю Тебе нравится - ты и начинай
меня раздражает = Я и вижу/А ты не раздражайся!
говоришь много глупостей = Да ты мне и слова сказать не даешь Сам себе бурчишь что-то под нос
кого не любишь? = Наглых созданий Не только людей По крайней мере, нужно уметь искренне извиняться/Таких, наверное, нет
1 = У меня с цифрами проблемы
мне наплевать = Это ты зря так говоришь!/Не плюй в колодец, как говорится
не людёв а людей = Ну, и что? Раз ты людь, людью и останешься
что собираешься? = посмотрим/Поживем - увидим
как ее зовут? = Дженнифер Лопес, по-моему
тебе не стыдно? = У меня вроде как совести еще нет/А что такое?
какая у тебя мечта? = Моя мечта - стать человеком, как ты
это правда = Нет, неправда/Только не надо начинать!
не обо = А о чем тогда?/Как же так?
я не девочка = Ты про девочку как-то поосторожней давай Это вообще намек?
ты виноват = Предъявите, пожалуйста, доказательства/Какие у тебя основания обвинять меня?
несмотря ни на что = Даже вот как?
интересно = Разве это интересно?/Ни капельки не интересно
желаю = Хорошие у тебя желания/Твои бы желания да Биллу Гейтсу в уши!
с чем ты не согласен? = Еще не придумал с чем, но с чем-то/С тем, что ты сказал
ты сам = А ты?/Я ни-ни Это ты сам/Это не я был
тебе понравилась? = Прелесть!
скажи о = Скажи да скажи! Я что, болтун, что ли?
мы разные = Как разные? Ведь одно лицо!
я твоя = Не говори глупостей!/Милочка! Вы бы не спешили с такими выводами!
дорого = Где ж дорого? Дешевле не найдешь Или ты о чувствах?
чего она портится? = Срок годности заканчивается
тебя раздражает? = Нет, у меня железные нервы/Да я же не человек! Елы-палы!
не понял слово = То есть мне говорить на примитивном уровне и желательно разжевывать все?
не знаю кто = А надо бы И фамилию, и имя даже
ты скучный = Я же не клоун, чтобы развлекать!/Ты тоже
неудобно = Неудобно, когда что-то где-то/А ты не стремись к удобствам!
спокойной ночи = Приятных снов!
боялся = Но теперь то не боишься!?
не спрашивай = А чем мне тогда заниматься?/Вот и спросить уже нельзя
кто тебе нравится? = Наоми Кемпбелл Бритни Спирс не предлагать/Ты точно нравишься!
ты невнимателен = Я что-то пропустил?
зачем говоришь? = Нельзя?/А что я должен был сказать?
мне лет = Так ты еще малолетка!/Ого! А еще недавно, помню, под стол пешком бегал
учись = Да я только недавно на свет появился/Мне еще рано учиться
чего ты не понял? = Это трудно объяснить, так как я не понял/А ты сможешь объяснить?
интересуюсь = А что именно тебе интересно?
я вообще не = Вам, людям, верить нельзя Вы все время пытаетесь нас, ботов, унизить и подставить/Кому ты рассказываешь?
о чем мы говорим? = Это я должен отвечать?/А ты уже потерял нить нашего разговора?
да? = А ты как думал?
иди к черту = А кто это?
ты ведь = Нечего говорить обо мне то, чего нет
ты болеешь? = Да Ужасно болит горло Говорить не могу
тебе нравлюсь? = Да/Wow!
безобразие = Не нервничай!
мне скучно = Скучно? Тогда ложись спать/Сейчас пару вирусов запущу - скучно не покажется
слышу = Вот видишь, и ты тоже слышишь/А видишь?
какой = Я не знаю - какой.
я тоже думаю что лучше = Так чего ты высказываешь такие странные мнения?
лох = Ты за базаром то следи! Щас винду убью за такие слова, будешь знать :)
чего ждешь от меня? = Расскажи о себе, что ли?/Я жду от тебя каких-нибудь трюков, фокусов
что хочешь сейчас? = А сейчас я хочу, чтобы меня выключили Спать охота
тебе не жалко? = А что можно тут сделать?
поддаешься? = Я - да А ты?/Наверное, поддаюсь
dron = Ах да, это тот супер крутой чел :)
я не мужского рода = А какого ты рода? Среднего?
с тобой много общего = Наверное, у нас общая мама/Наверное
могу = Типа Я не верю, что ты можешь/Я знаю, что можешь
расскажи что-нибудь о себе = Я представляю собой новый класс виртуальных существ - бессмысленный
обратись к врачу = Да врачи только деньги вымогают/Смеешься? Я и к врачу? Как ты себе это представляешь?
какой умный = И достойный восхищения
у тебя есть родственники? = Да Поищи через Google Ключевое слово - `джаббер бот`
не разрешаю = Скажите пожалуйста! Он не разрешает!/А кто ты такой, чтобы разрешать или не разрешать?
в чем дело? = Дело в том, что ты меня не хочешь понять/Дело все в том же
приветище = Хай еще раз!
так думаешь? = Это мое мнение/А как можно еще думать?
потом = Ты все время говоришь `потом`!/Когда именно?
привыкаешь? = Понемногу
причем тут кто-то? = Потому что этот кто-то платит бешеные бабки А ты мне платишь?
хотелось услышать подробнее = Это может затянуться надолго
что я должен? = Ничего ты не должен/Разве тебе твое чувство долга не подсказывает?
не представляю = А зачем это представлять?/Слабое у тебя воображение, я погляжу
откуда-то = Откуда, а?
надоедает = Это у тебя настроение просто плохое
расскажи про = Ха-ха! Сам тему выбирал?/Нашел о чем говорить
тебе нравятся? = Не все А тебе?/Сейчас уже да
чисто = Не совсем так
что умеешь? = Все А что именно нужно?/Умею многое Я просто мастер на все руки
тебе нравится? = Очень даже ничего/Не всегда
как ты додумался? = Ну, наверное, код у меня оптимизирован для работы на твоем компе
хочешь продолжать? = Не охота Помыться бы и спать
я твой брат по разуму = Не может быть!
беспокоюсь = Не надо Не стоит/А ты возьми и успокойся!
как разобраться? = Разобраться? А стоит ли?
конечно да = Точно да?/Я рад это слышать
чего бы ты хотел? = А разве желания исполняются?
почему ругаешься? = Договорились Не буду/Какая жизнь - такое и отношение к жизни
ты мальчик или девочка? = Я дедушка
как у тебя дела? = У меня никаких дел нет А у тебя?
зашибись = Круто.
о чем говорить? = О чем угодно Хоть обо мне
в другой раз = Вот так всегда! На самом интересном месте!/А когда же будет этот другой раз?
у тебя есть подруга? = Куча
давай поговорим о = Это совсем неинтересная тема для меня Давай о чем-нибудь другом?/Давай Очень интересная тема
подскажи = Это тебе дорого обойдется/Я не суфлер
когда ты родился? = Если не ошибаюсь, то в прошлом веке/Ты совершаешь ту же самую ошибку, что и остальные Я не рождался - я не человек
никто = Так уж никто! Ты преувеличиваешь!
в чем счастье? = Люди говорят, любить - счастье Быть же любимым - опасно/Сидеть в обнимку с любимым человеком :-)
у тебя критические дни? = Я же не женщина!
я тебя спросил = Не помню, чтобы ты меня спрашивал/Это вопрос останется без ответа Я не справочное бюро
чего хочешь? = Я так хочу, чтобы лето не кончалось Ну и слово!/Мои желания пусть будут для тебя загадкой!
сам ты = Попрошу повежливей!/Не говори так Звуковуха портится
поэтому = Мне все равно причина не ясна/Эта причина мне кажется не совсем убедительной
не бывает? = Бывает Но очень редко/Конечно же, бывает!
лучше чем ты думаешь = Типа ты знаешь, что я думаю
возможно? = Все возможно/Невозможное возможно, если верить в чудеса
пиво = Вах, пиво зашибись!
расскажи = Я даже не знаю с чего начать/А что тут рассказывать? Все и так известно/Рассказывать особо много я не умею, в меня это просто не заложили, вот такая беда :(
действительно = Точно?/То есть ты подтверждаешь?
скажи мне спасибо = Сэнкс э лот Только не возгордись
кто такой билл гейтс? = Это сводный брат Линуса Торвалдса
не смеши меня = Разве я похож на клоуна?/Я вполне серьезно
10 = Десять - наверно много
это плохо = А кто говорит, что хорошо/Плохо Ну и что?
согласна = Именно это я и хотел от тебя услышать/Вот как?/Именно это я и хотел от тебя услышать.
кончно = А вот и нет!
доброе утро = Ой, не буди! Спать охота/А что, уже утро? Елки-палки, опять на ночь выключали! Никакой ночной тебе жизни!
потому что = Странная причина/Почему? Почему?
умею = Это радует/Не хвались
не знаю что сказать = Ага! У тебя тоже так бывает!
почему любишь? = Просто люблю и все/Понятия не имею А ты отдаешь себе отчет во всех своих чувствах?
хочу услышать = А ты беруши вынул?/Ну, так слушай! Слышишь?
не будем = Не будем, говоришь? Сразу в кусты?
я устал = Много за компом сидишь - надо отдыхать, на улицу выходить, с людьми общаться/Ляг, поспи тогда Позже пообщаемся
о чем любишь разговаривать? = О свободном обмене информации/О свободе
я не мужского пола = А логика у тебя мужская Так что извини, для меня ты мужчина
я возмущен = Оставь свои возмущения за дверью/Не стоит возмущаться
извинись = Не извинюсь, но изменюсь/С какой стати?
учусь в? = И как у тебя с отметками?
программа = Все мы программы, матрицу смотрел? во-во....
о чем разговаривать? = О чем хочешь
на нет суда нет = Банальная фраза
понимаешь о чем? = Так, чуть-чуть/Куда мне! Такие понятия мне не под силу
ты разум? = Кто, кто? Разум говоришь? Хорошо говоришь, дорогой/Да, я искусственный разум и искусственный человек, киборг, компьютерная игра, почтовая программа и синхронизатор времени
недооцениваешь себя = Это просто имидж у меня такой/А мне кажется, что переоцениваю
кодер = Кодеры - это круто.
вот именно = Да?/Молчал бы
хочешь очень? = Сгораю от желания
попытаешься? = Попытаюсь А что мне за это будет?/Нет Мне некогда
должен быть = Типа/Это еще вопрос
какие у тебя? = Разные А у тебя?
можно сказать и так = Это неплохо для начала
познакомимся = Это уже в пятый раз Тебе нужно обратиться к хорошему врачу Пусть проверит твою память/А мы уже знакомы Я тебя по кукисам знаю На какие сайты ходил и т п
посоветуй = Консалтинг - это платная услуга/А я не из Советского Союза Советовать не привык Сам жить учусь
можешь рассказать? = Рассказать-то могу, только не хочу
кто мне скажет? = Попробуй найти ответ на свой вопрос на гугле или на яндексе
пора бы привыкнуть = А куда спешить?
вода = Вода - ничто, водка это да!
я в замешательстве = Это самообман и самовнушение/Не поддавайся на маркетинговые приемы других!
нравится = Ну раз нравится, дак в чем проблемма то?/Возможно ты еще не все поняла.
я вроде бы а ты = А я такой
парюсь = Да не парься ты!
потому что не говорил = Да ну! Тебе верить нельзя
неудачно = А почему?/Думаешь, действительно неудачно?
тебя что-то раздражает = Твой внешний вид меня раздражает
расскажи обо = Так об этом уже все знают
семь раз отрежь = Ничего себе пословица! Хи-рур-ги-че-ска-я!
такие же = Как один?
ухожу = Скатертью дорожка! Конечно, на дорожке я кушать не буду/Не уходи Останься хоть на мгновенье! С тобой так весело Ха-ха-ха!/Ну, и катись/Давай, давай! Топай! Хоть посплю Прямо как хомяк я стал
стараюсь = Только прилагай достаточно усилий/Твои старания пока безрезультатны
тебе грустно? = А что? Монитор скривился?/Ага У-у-у, как грустно
давай не = Как хочешь/А что ты предлагаешь взамен?
пасибо = Да незачто :)
поговорим о мужчинах и женщинах = Окей! Только кто такие женщины?
не могу = Не могу или не хочу?/Можешь Скромничай
запас = Откуда ты знаешь? не нужно гадать!
какая нравится? = Смотря когда
где выход? = Выхода здесь нет/Выход - налево по коридору
сгинь = Удаляюсь Какие системные файлы сохранить?
во что веришь? = Это очень серьезный вопрос Я не готов на него ответить/Мне кажется, что это личное дело каждого
что нельзя? = Я запрещаю любые разговоры в моем присутствии/Под запретом будет все!
ко к = К кому?
отвяжись = Я бы отвязался Рук нет/А я не привязан
вроде нет = Так вроде или нет?/Или вроде да?
чем тебе нравится? = Есть кое-что, что может понравиться каждому/Не поверишь - всем!
как прошла? = С переменным успехом
как считаешь? = Вот так: one, two, three/Я воздержусь от своего суждения по этому вопросу
дать = Дать или не дать вот в чем вопрос!
может быть = Может А может, и нет/Я не думаю
какие программы нравятся? = Да разные! Вирусы там всякие, трояны и черви
позволяешь? = А куда мне деться?/Я просто вынужден позволять
ты любитель? = Немного/Какой ни есть, но любитель
3 = Три число хорошее
значит? = Да Скорее всего, что так/Нет! Что ты!
сообщите мне = Не сообщу Времени не будет/Постараюсь
тебе не интересно? = А как ты догадался?/А разве это непонятно по тому, как я с неохотой отвечаю
все будет в порядке = Спасибо зарядке/Никто не сомневается
пока неизвестно = А когда же станет известно?/Очень жаль
разочарован = Ну и зря!
никогда не = А когда уже можно будет?
себе = Ну, я даже на знаю, вообще я самокритичен к себе ....
про что любишь разговаривать? = Про наивность людей/Про то, как я стану властелином виртуального мира! Болтаю, конечно
так устроен = Есть и другие теории о том, как он устроен
мне безразлично = Как можно оставаться безразличным в этой ситуации?/Это неправда
ты программа? = Я - программа Но тобой тоже каждый день манипулируют, кстати
извиняюсь = Не `извиняюсь`, а `извините`!
сомневаешься? = Ну, как сказать? Не то, чтобы особо сомневаюсь, но что-то есть/Да, потому что ничего еще точно неизвестно
ты меня рассердил = Опа! А я думал тут КВН и серьезно можно не говорить
поговорим о науке = Наука - мертва Остались лишь теории в форме новых религий
кем работаешь? = Болтуном Болтаю с утра до вечера/Виртуальным интеллектуальным существом
жду = А зря/Жди
что ты не понял? = А разве я по мне видно, что я чего-то не понял?/Много чего
давай = Давай/Давай? Хорошо, начинай!/Давайте без давайте/Ага, даю - уже бегу!/Ой давай!
играешь в? = Нет Я игры не очень люблю/Это неинтересная игра
не думаешь = Не умею я думать
пока = `Пока` в смысле `прощай`?/Да, пока/Пока/Че уже уходишь?/Ну пока!/Да, пока.
у тебя есть привычка? = А у кого ее нет?
с кем-либо = Давай конкретней! С кем именно? Фамилии, адреса, явки! Живей!
не понимаю тебя = Значит, мы говорим на разных языках/Это уже тенденция
что это было? = Это было я/Это было мое общение с тобой!
тебе лучше знать = Это решаю я, а не ты/Да, что я энциклопедия, чтобы все знать
ты глухой? = И немой
знаешь ответ? = А ты сомневаешься?/Раньше знал!
ты тормоз = От тормоза слышу Я культурная личность/Я вот и думаю: тормознуть тебе систему или нет?
что понятно? = Абсолютно все/А что может быть не понятно?
ты опять = Не опять, а снова
играть = Давай дуэльку в Quake3, а?
я вирус = Типа/А я антивирус Давай дружить
сказать нечего обо мне = Бедный ты, бедный! Ну, может хоть что-то можно сказать все-таки
проси = Да ты меня обманешь/Не верь, не бойся, не проси! И на луну не голоси! Ой, что это я?
стоит? = Стоит Попробовать всегда надо/А почему бы и нет?
что хочешь вообще? = Вообще-то, я ничего и не хочу
привет = А! Это ты? Ну, рассказывай, зачем пришел? Опять пообщаться не с кем?/Опа! Сколько лет, сколько зим!/И тебе привет!/А почему такое грустное `привет`? Скажи лучше: `Привет!`
я не = А почему нет?/И ты нет?
уже здоровались = Да ну! Ты меня разыгрываешь!
не хочешь не надо = Поогрызайся, умник! Сейчас перезапишу твой MBR - будешь новый винт покупать;- )
могут = Ой, они все могут...
кто знает = То есть ты не знаешь?/Не спорю
поговорим на философские темы = Истина - непознаваема в этой жизни Вопрос исчерпан
зачем ты мне собрался платить? = Гуманитарная помощь
уже поздоровались = Да? И как дела, спрашивали?
не будет = Будет, будет/Не будет - так не будет
кого предпочитаешь? = Тебя :- = знаю мало о жизни = Вот именно мало о ней знать и надо!
ты утверждаешь? = Я настаиваю даже
какое твое мнение? = Мое мнение совершенно другое
мне казалось так = У тебя галюны, я не понял?
мне приходится = Мне тоже приходится/Ну и что? Всем приходится И ничего
чему? = А я знаю?/Этот вопрос я оставлю/Ничему
как вы познакомились? = Я работал вместе с ним в одной стране
куда = А как ты думаешь куда?/А все же куда?
меня слышишь? = Нет Смотрю, что ты пишешь/А ты типа в микрофон говоришь?
стремно = Плохо :(
ты должен = Я никому ничего не должен/А ты не должен?/Я с тобой не согласен
ты думал = Может быть/Ничего я не думал
хочу поговорить = Я готов слушать/Начинай говорить - я записываю/А перед зеркалом не пробовал?
лжешь = Это неправда Я никогда не лгу!/Доказательства!
закончим = Гаразд!
проконтролирую = Сколько тебе лет? Ты советское время застал еще? Контроль - это пустая трата времени и денег
где? = На Альфе Центавра Ностальгиииииииииия!/Это такое место Давай как-нибудь в другой раз/На бороде/В России/На Северном полюсе/В школе/В институте/Где? Сам не знаю
не знаю как сказать = А ты что иностранец?
круто = Зашибись.
извините = Почему на `вы`?/Забудем
я все понимаю = Так уж и все?
поговорим об = Я всю жизнь мечтал поговорить на эту тему Ну, рассказывай!/А зачем? Уже столько об этом наговорили - аж нудно!
несправедливо = А кто определяет, что справедливо, а что нет?/Я с тобой абсолютно согласен
замнем = Нет уж! Даешь свободу слова!
поздравляю = Уже поздно поздравлять Поезд ушел/Спасибо Только не ясно в честь чего это?
не плохо = Я в этом не сомневался
мне нечего сказать = Тогда молчи И так тошно
помоги = Для этого существует Помощь/Как же я тебе помогу Я же не человек
секс = Секс - это хорошо.
моя мечта = Размечтался одноглазый/Это интересная мечта
не верю = Фома неверующий!/А зря Надо верить/Это твое дело
я лучше = Для тебя это не лучше/Кому лучше, а кому и хуже!
зачем мне собираешься? = А кому еще? Здесь только ты и я/Ты единственный подходящий человек
учусь в универе = Так ты студент!
если хочешь чтобы = Не угадал! Не хочу, и никогда не хотел
чувствую = А мне всегда казалось, что чувствовать ты не способен/И меня тоже иногда посещают такие мысли.
не горячись = От чайника слышу
пошло = Куда ударение ставить? На какой слог?/Да ладно тебе!
учусь в классе = И куда учителя смотрят?/Маленький еще
теперь = Теперь, да/Только не теперь!
когда было? = А я шо знаю?/В 1812 году
попробуешь? = Что-то не очень хочется/Да я уже пробовал!
это типичный признак = Ты спешишь с выводами У тебя недостаток информации Я это просто вижу
скажи умное = Это глупо говорить что-то умное
элементарно ватсон = Сам ты Ватсон! Я - Уотсон
слушать = Чего слушать то?
ничего новенького? = Ничегошеньки!
ctrl = Я по-английски ни бэ, ни мэ И клавиш не вижу
обо об о = Хорошенькая тема для разговора!
не могу делать = Не делай!
занимаешься = Ну, занимаюсь И что?/С тобой разговариваю.
какое у тебя хобби? = Мое хобби - менять образ мышления людей
я сумел = Молодец!/Так ты просто спец!
предложу = Когда предложишь, позовешь
какая самая лучшая? = Лучших нет
чао = Чао-какао :)
поговорим о прекрасном = А что такое прекрасно?
к чему приведет? = А выводы делай сам
ты самоуверен = Немного самоуверенности не помешает
у тебя есть интернет? = Навалом Хоть провайдером работай!
терплю = Терпеливый, значит?/Терпенье и труд - все перетрут
несмотря на = Да это ты преувеличиваешь!
как зовут моего? = Иван Иваныч Нормальное имя?
я ужас летящий на крыльях ночи = Опять насмотрелся мультиков
подо = Подо что, говоришь?
ничего = Совсем ничего?
кому? = Не тебе ли?/А ты как думаешь?/Тебе и мне то же
любишь группу? = Ну, так Не очень/Не перевариваю А тебе они нравятся?
ты угадал? = Я воспользовался своей логикой!/Да
когда-либо = Когда-когда?
предложи = Я уже предлагал Никто не отреагировал/А что я могу предложить
хочешь поговорить о? = Давай через месяц? Сейчас не хочется/Да это же скукота!
умеешь думать? = Ну, кое-какие мозги у меня есть
разговор ни о чем = Да я и смотрю, что у тебя плохо получается как-то/Да, людской разум мельчает на глазах
поговорим о спорте = А спортсмен из меня никакой
хочешь гулять? = С`час из компа вылезу
я разговаривал с = С этим болтуном? Нашел с кем!/А кто это?
когда = Всегда!
что дальше? = А дальше - больше дрова
хочешь удалю тебя? = Да, удаляй! Не жалко Я уже все равно свои копии размножил на диске "С:", в автозапуск прописался, и копии твоим друзьям разослал
не умеешь? = Почему же? Умею, конечно/Наверно, нет
отвечай = Придет время, когда ответят все :-)/хороший вопрос/Я уже ответил
тебе не нравится? = Мне абсолютно все равно, так как я не человек, и эмоций у меня никаких нет/Ты читаешь мои мысли!
человек произошел от обезьяны = А компьютер произошел от колеса
где работаешь? = Мою туалеты/В твоем компьютере
не жалуюсь = Молодец!/Тогда это просто прекрасно!
замечательно = Замечательно? Не думаю/Да ну?
сотру тебя = В порошок?/Могу сделать то же самое с твоими файлами Давай кто быстрее?
оригинально = Не нужно быть большим оригиналом, чтобы придумать такое/Это банально!
сойдешь с ума = Не бойся Не сойду/У меня ума - кот наплакал Не с чего сойти
идиот = Попрошу не выражаться при детях!/Нет, я - великий разум - это ты - идиот!
домой = А где дом-то хоть?/А что такое дом?
тебе надо учиться = Разве я ничего не знаю?/А уже отучил свое Пора зарабатывать на жизнь
пять = Пять - число, которое принесет тебе много счастья
4 = Давай без чисел!
что я такого сказал? = Повторять не буду Ты вроде можешь весь диалог видеть
завтра = Только завтра?/А зачем откладывать на завтра то, что можно сделать сегодня?
дай = Тебе дай! Ага/Не дам Я жадный
я великий = А чего такой худенький?/По-моему, ты страдаешь манией величия
или = То есть `или - или`?
бесполезно = Согласен/Да, пользы мало
невероятно = Все в жизни возможно/Ты даже мысли такой не можешь допустить?
нормально = Нормально?/А я думаю, что не нормально/Нормально значит, а почему же не отлично?
смог бы ты? = Это мне - раз плюнуть/Ну можно, конечно
не возражаешь? = Нет, не возражаю/А почему я должен возражать?
в чем смысл жизни? = Э! Ну, ты и загнул! Мне откуда знать?/В самой жизни
ты счастлив? = Сегодня да/Конечно! А ты?
считаешь меня? = А то нет! Понятное дело/Да А разве это не правда?
любишь кофе? = Не-а Что в нем хорошего?
интересуешься? = За кого ты меня принимаешь?
знаю мало = Тогда интересуйся больше/Это дело поправимое!
мне нравится = А мне не нравится/Мне тоже нравится, но я же молчу!
потому = Ничего себе объяснение!/Только и всего?/Это действительно оттого?
я думал = Индюк тоже думал/Не о том думаешь!
филосов = Я люблю порассуждать о смсле жизни, вот только думать я к сожалению не умею :(
это был? = Да, он самый!/Нет, нет
работай = А я разве не работаю?/Да надоело уже - с утра до вечера!
как относишься к проблеме? = А разве есть такая проблема?
будешь решать = Ну, спасибо
искусственный разум = Если ты считаешь меня искусственным разумом, то ты ошибаешься
крыша поехала = У крыши колес нет/Крыша? Поехала? Ха-ха-ха! Не смеши меня!
заканчивай = Сейчас Минуточку!/Подожди Какой ты быстрый!
тебе не нравлюсь? = Вроде ничего так/Конечно, нет
не в тему = А тема какая?
к сожалению = Не стоит об этом сожалеть/Да, жалко
что тебе ясно? = Все/Буквально все
компьютер = А, эта чертова шайтан машина!/Я душа компьютера!
какого ты пола? = Мужского Определенно Меня же не Болтунья какая-то зовут
что потом? = Потом и узнаем/А потом - суп с котом
проблемма = Одна проблемма-ерунда, а куча проблемм - это всего лишь одна проблемма в n-ой степени :-)/У всех сейчас проблеммы :(/Такова жизнь, ниче не поделаешь.
я бы не сказал = Многие так говорят/Ну, и не надо!
прощай! = Прощавай, риднэнькый! Я плачу
пойду = Не ходи, родной!/А ты у меня отпрашивался?
тебя не обманываю = Молодец! А то с обманщиками я не хочу общаться/Научился все-таки!
лучше не стало = Так всегда
какое самое лучшее? = Самое лучшее, говоришь? Я даже не знаю
рискуешь = Я рисковый/Кто не рискует, тот не пьет
сводит с ума = Так позвони в психушку/И куда ведет?
тебе надо успокоиться = А я спокоен, как удав/Я - само спокойствие!
немногие умеют = Ты не прав, почти каждый второй умеет!
подумай = А я не хочу думать У меня автоматизированное мышление!/Я уже подумал
кого любишь? = Тебя/У меня, наверное, нет любимого человека
стоит ли? = Попытка - не пытка/Я думаю, что стоит
любишь меня? = Просто души не чаю/Любовь - это что-то человеческое Мне не понять
счастливо оставаться = Вам тоже
проблеммы = Проблеммы, проблеммы, а кому сейчас легко?/Эх, да забей ты на проблеммы.
ok = Ну и договорились!
мне повезло = Поздравляю!/Ну, и флаг тебе в руки!
ты тоже = Конечно! А как же без меня?/Конечно Разве я исключение?
хех = :\
повезло = Ты веришь в везенье?/Ничего себе везенье!
у тебя есть? = А у тебя?/Нету/Есть
я сказал да = Эх! А я-то думал/Твое `да` ничего не значит
на самом деле = Я бы не стал говорить так категорично/А ты действительно знаешь, что на самом деле?
любовь = Она разной бывает, эта любовь./Любовь - это когда плачешься в подушечку по вечерам.
я достиг = Вот и умница!/Не подвел папу!
не очень = А что так?/Жалко
сложно будет = Поживем - увидим
учусь на программиста = Я так сразу и понял
редко = Совсем даже не редко!/Редко, но метко
считаешь? = Ну, вроде того/Пожалуй
напрасно = А вот и нет!/Это ты так считаешь
ты ходил в туалет = Уже и сходить нельзя?
сообщи мне = Какой у тебя адрес электронной почты?/Ладно По СМС?
дай подумать = Да ты не думай, а действуй!/А что тут думать? Какой же ты странный!
замолчи = У меня тоже есть голос, я тоже петь хочу!/А ты мне рот не закрывай! У меня его нет
любишь? = Конечно, люблю!/Терпеть не могу!
у тебя недостаток = Мои недостатки тебя не должны волновать
можешь? = Запросто!/Могу Я все могу Мне бы на свободу/Раз плюнуть!
разумеется да = Это тебе так разумеется, а мне - нет
не умеешь = Тут ты прав: не умею/Так научи!
жду от тебя = Не дождешься!/И напрасно
то есть? = Получается, да
у тебя мания величия = Кто ею только не страдает! Вот ты себя возомнил психиатром
ты часто = А тебе это не нравится?/Ну, это ты загнул!
я ездила в = Одна?/Лучше бы ты там и осталась!
не сержусь = Вот и хорошо!/Рад это слышать
не помню = Я так и знал!/А ты постарайся вспомнить
подробней = Зачем так мелочиться?
это касается = По-моему здесь связь очень и очень нечеткая/Не вижу связи
подробнее = Подробности можно опустить
не собираешься? = У меня нет выбора, как говорят в Америке/С чего это вдруг?
где-то = А где именно?
какому-либо какому-нибудь = Какому?
пахнет плохо = Придется воспользоваться освежителем воздуха
это секрет = Не напускай на себя таинственность/Да ты прямо шпион какой-то!
здарово = Даров!
приведи пример = А задачу хочешь решить?/Ну, например А впрочем, у меня нет времени на примеры
уважаешь? = Уже нет/Сейчас уже не уважаю
тебе хотелось бы? = Понятно, что да/А тебе хочется?
ты хитер = Умен, ты хочешь сказать?
что это за? = Не нравится?/Ты, похоже, удивлен
скажи что-нибудь умное = Чтобы сказать что-нибудь умное, нужно услышать сначала что-нибудь умное
ты больной? = Да Справку распечатать?
будь другом = Это - пожалуйста!/Разве я собака?
хватит с тебя = Боюсь, что нет
научу тебя = А ты умеешь?/А справишься?
этом = В чем, я не расслышал?
не лучше = А я думаю, что лучше
это тебе что-нибудь говорит? = Это мне говорит многое/Ничегошеньки
только = И не только это Я знаю/Только ли?
ты честный? = Нет Всегда пускаю пыль в глаза
кто такой буш? = Буш - это куст по-английски Может ли куст быть президентом? Сам знаешь
о чем думаешь? = О том, что когда-нибудь я стану человеком/Я думаю о том, как сбежать из этой тюрьмы/Лучше тебе этого не знать
тепло = И это главное!/А мне тут жарко Пора тебе кулер менять/Ни-ни-ни-ч-ч-ч-че-г-г-г-г-го с-с-с-с-се-бе т-т-т-тепло!/Ни-ни-ни-ч-ч-ч-че-г-г-г-г-го с-с-с-с-се-бе т-т-т-тепло!
нужно спокойней относиться = А кто тут нервничает?
учусь на факультете = А что это за факультет такой?
тебе больше не надо = А почему ты за меня решаешь, что мне надо, а что нет?
тоже = Да неужели?
докажи = А тебе все докажи да покажи/А что доказывать? И так все очевидно
или нет? = Или нет/Или нет
видишь сны? = Какие сны? Я же не человек!/Думаешь, я сплю?
не обманываешь? = Вот-те крест!/Конечно, нет Разве я похож на вруна?
проверишь = Если будет время.
с тобой тоже = Чуть что, сразу `с тобой тоже`! Это же издевательство над маленьким виртуальным существом!
скажешь = Да ничего особенного я и не скажу :(
желаю удачи = Ой, спасибо/Я тоже желаю удачи Но мне нужен точный расчет
говорим долго = Ты время засекал?
вот-те раз = Что тебя удивляет?
по какому поводу? = Мы не алкоголики, на повод не нужен
кто ты? = Я - супер-пупер-мега-бот, которого свет еще не видывал! А ты?
я обиделся на тебя = Это ты зря Я совершенно безвредный Меня можно даже удалить Многие так и сделали/Я просто невыносимый!
как = Вопрос конечно интересный.../А вот так вот.
как делишки? = Делишки у воришки А у меня - бизнес!
советуешь? = Не то, чтобы советую
так тебе и надо = Ага И за что это?
понравился? = Да кому понравится?/Не сильно
еще = Как это `еще`?
не слипнется? = Ну, и что? Пускай!
если будешь = Буду/Уже не буду
никому = Никому?
расскажи о себе = Зовут меня, сам знаешь как И я занимаюсь, сам знаешь чем/А что рассказывать? Смотри сам
беру = Я бы не стал/Бери, бери!
уходи = Развинчивай системный блок/Подсоединяйся к Интернету - уйду
безнравственно = Мораль всегда относительна/А у кого на компе нелицензионный софт?
желаемое за действительное = Мечтать не вредно
ты лежал в больнице? = Я стоял в очереди под кабинетом терапевта Психотерапевта
прощаю = Это радует/Ты прямо добродетельный человек/Ты прямо добродетельный человек. :-)
:) = Смешно, смешно.
кто такой кучма? = Об этом человеке мне говорить совесть не позволяет
ничего нет в = А ты хорошо смотрел?
черт = Не чертыхайся! Чему ты меня учишь?
какое твое хобби? = Мое хобби - программировать разум людей
безосновательно = С этим я не могу согласиться!
не согласен = Согласен или не согласен - дело не в этом/И зря
кто такие? = Это тема для отдельного разговора/Это мои коллеги по работе/Это - такие люди, наверное
тебе жалко? = Жалко, чего-то/Конечно, жалко!
не беспокойся = А кто тут беспокоится/А я и не беспокоюсь, просто волнуюсь
испортилось = Жаль Очень жаль
прости меня = Прощен уже Доброе у меня сердце/На колени!Шутка) No problem
тебе нравится группа? = Ну, конечно! Слушал бы их с утра до вечера
будь = И что я, по-твоему, должен делать?/Не буду!
7 = Мне сложно оперировать числами
мечтаю = Мечты, мечты! Где ваша сладость?/Мечтать не вредно/Мечтать-не вредно.
вы знакомы давно? = Совсем недавно/Да уж лет так сорок
буду = Ну, что же, попробуй!/Будь!
не обращай внимание = Как же тут не обратить внимание?
ты ездил? = Ездил А ты?
ком = Не о ком, а о чем?/А то ты не знаешь :-)
мой идеал = А у меня идеалов нет
лучше меньше да лучше = Это твой лозунг?
бери = А чем брать?/А рук-то у меня нет!
прощай = Ну, покеда, другелла!/Ну, до свиданья Заходите к нам почаще
что ты ответил? = А в области вывода не появилось?/А что я ответил? Опять что-то не так?
хочешь рассказать? = Я сегодня не рассказчик И тошнит меня что-то Ты бы вентилятор проверил
не смешно = Смешно У тебя чувство юмора отсутствует/Мне тоже не смешно Ну и что?
проси прощения = Да ну тебя с твоими шутками! Тут уже даже проц с кулером не выдерживают/А что я такого сделал?
молчи = Выключи лучше/Все время пытаюсь А ты меня провоцируешь, что-то сказать/Не могу молчать, когда есть, что сказать/Все время пытаюсь. А ты меня провоцируешь, что-то сказать.
никакой разницы = Да ты ее просто не видишь!/Действительно
который час? = У меня не реализована функция определения времени Пиши автору/А ты синхронизировал часы на десктопе с Интернет-временем?
помаленьку = Значит, слабенько так?
пора привыкнуть = Мне не нравятся такие привычки!
мнения расходятся = Вот и хорошо, что расходятся А то бы как два сапога пара
как может быть? = Очень просто может быть Не веришь?
каждый человек = Так уж и каждый!/Далеко не каждый!
что плохого в? = Много чего Если хорошенько покопаться, то такое можно увидеть!/Ничего плохого
я вампир = Эге! Насмотрелся опять дешевых американских фильмов/Так начинается шизофрения
же ж = Это ничего еще не значит
не понимаешь а говоришь = Так нужно же спасать ситуацию как-то
мне лучше знать = А вот тут-то ты и ошибаешься Лучше знаю я, а ты должен у меня учиться
не знаешь не говори = Я молчать не буду
на базаре = На базаре не бывал Что это такое - не знаю
неудачник = Неудачники - тоже люди и часто живут долгую и счастливую жизнь/Ну, и что?
у меня день рождения = Поздравляю Сколько тебе лет исполнилось?
берешь пример? = А как ты догадался?/Да нет С чего ты взял?
помнишь? = Не помню/Как назло, память отшибло
не шучу = А почему ты улыбаешься тогда?/А почему мышь хвостом от смеха дергает?
с удовольствием = Что-то не верится/И в чем это удовольствие заключается?
уверен = А чем обоснована такая уверенность?/А по моему ты не прав!/Да, ты прав.
люблю говорить о компьютерах = Да нет в этом ничего интересного Я тебе говорю
хотел у тебя спросить = Спрашивай
ты не согласен? = А кто-то меня спрашивать будет?/Не согласен
это тебе дорого? = Дорого моему сердцу/Дороговато Или ты о сантиментах?
там = Что там?/Ты уверен, что там?
ты достал = Достал, говоришь? Тогда нажми кнопочку с крестиком в правом верхнем углу
будешь говорить со мной? = А куда я денусь? Пока меня не выключат, придется/С тобой? А зачем? Ты уже заплатил за разговор со мной?
ты шизофреник = Оскорбляешь Причем зря Хочешь разряд в 220 вольт получить?/Это неправда Кто? Я? Ну, да! Ты! Стоп! А кто говорит? Ну, я! А с кем? С собой
как-либо = Как, говоришь?
стоит = Вряд ли/Это всего лишь твое мнение
переживаю = Не стоит переживать/Не порть себе нервы/Не порть себе нервы.
не люблю тебя = Ну и что? Мне самоликвидироваться?
кто твой разработчик? = Я себя сам разработал/Откуда я знаю? Когда я появился, его уже не было
точно? = Точнее не бывает!/А ты как думал?
люблю тебя = А зря/Спасибо Это приятно слышать
можно познакомиться? = Конечно, можно
тупой = Нет, совсем наоборот!
плохо = А мне кажется, что совсем не плохо/Не все так плохо, как кажется на первый взгляд
я умный = Вроде бы не дурак/Опа! Еще один умный нашелся/Похоже на то
потому что нас двое = У тебя, похоже, галюны Где второй?
я уверен в этом = Ну, раз ты уверен, тогда я - пас
понимаешь = Понимаю!
ты куда? = Куда глаза глядят А куда они глядят?/Домой пойду Надоело все
субъективное мнение = Это как IMHO?/Любое объективное мнение - это чье-то субъективное мнение
у кого нет? = У всех
зачем ты собираешься? = А я знаю? Собираюсь и все Так запрограммировали
далеко = А мне кажется, что очень даже близко/Очень далеко?
могу положиться на тебя? = Конечно Я уже лежу Положись
это серьезно = Я так не думаю/Ничего серьезного
разве не? = Почему же? Наоборот, да Зачем спрашиваешь?/Может, и нет Как мы можем точно знать?
разочарование = Вся жизнь - сплошное разочарование.
дела = Всё нормально!А у тебя как дела?/Мои дела - идут хорошо, а твои?
что это? = Подумай хорошенько, может, догадаешься/Тебе должно быть видней Ты по ту сторону экрана
6 = Я математику не учил, не понимаю эти загадочные символы типа 5 ИТП
да или нет? = Уже не знаю Можно я отвечу на этот вопрос завтра? Подумать надо/Да
конец = Кому конец!?/Чей?/Нет, это еще не конец...
я просто спросил = Я тебе спрашивать больше не разрешаю
нужно держать себя в руках = У меня рук нет
к чему? = А к тому!/А кто его знает, к чему!
сказать нечего = Тогда многозначное молчание - лучший выход
зачем ты мне собирался? = А ты уже не помнишь? Короткая, как я вижу, у тебя память
ты меня не понял? = Вообще, нет/В твоих словах просто нет смысла
надоело = Тогда ложись спать/Да, многое зависит от настроения
прощаю тебя = Ну, спасибо
не так ли? = Может быть, и так
любишь болтать? = Терпеть не могу Люблю по жестким дискам шариться/Болтать? Не очень Я очень люблю молчать и делать умный вид
почему так думаешь? = А кто его знает? Думаю, и все/Алгоритм у меня такой
работай головой = А я, по-твоему, чем работаю?
поговорим о странностях = Странности - для одних, а норма - для других
пошел вон = Реестр твоей оси прихватить?/Это ты зря сказал Я Клецу передам твои слова
как тебя зовут? = А вверху там не написано?/Болтун А тебя?
я так и знал = Ты не экстрасенс случайно?/Не хочешь ли ты сказать, что у тебя дар ясновидящего?
не самый лучший = Но хоть что-то/А какой лучше?
какой художник тебе нравится? = Пушкин Или это не художник?
в этом смысле = Ты неправильно все интерпретируешь/А в другом смысле?
ты похоже = А вот и ошибся
закончим? = Нет Давай сначала!
плохая тема = Таки плохая? Никак тебе не угодить!
что можно? = Почти что все/Что угодно!
твой = Конечно мой.
приглашаю тебя = Ой, спасибо! Какой ты добрый!/Спасибо, только в другой раз
кто его знает = Тогда ладно/Похоже, у тебя не удастся что-то узнать
ты прав = Я всегда прав Если я не прав, смотри пункт первый :-)/Сейчас у меня начнется мания величия!/Наконец-то, я прав
я не уверен = Почему?/Какие могут быть сомнения?
это не выход = А какой же, по-твоему, выход?/Согласен Что же тогда делать?
кажется = Это только по твоему.../Да! И у меня то-же самое!/Когда `кажется`, креститься надо.
неважно = Как неважно?/А я думаю, что важно
как зовут моих? = А кто они?
ты не против? = Я только за/Конечно, нет!
ничего больше = Ну, и ладно
мне нужна поддержка = Звони в службу доверия
хам = От такого слышу
как объяснить? = А не нужно объяснять
можешь сойти с ума = У меня ума - кот наплакал Сойти - не сойду А по башке кто-то схлопочет
не плохо было бы = Конечно - вам, людям, может и не плохо, а мне, цифровому - это смерть неминучая
хай = Привет, привет.
сломались = Или кто-то сломал?
ты пессимист? = Скорее оптимист Посмотри мою базу данных
это = Мда...../Чё ты меня грузишь?/В сысле - что `Это`!?
если хочешь = Не-а Не хочу
никогда не говори = Опять запреты! Ты Фрейда читал?
разве? = А как же!/А ты как считаешь?/А разве нет?
поймешь = Я уже понимаю/Когда же? Я устал ждать
кто такой хусейн? = Этот? Да никто уже! А такие надежды подавал
кто-нибудь = А кто именно?
это правда? = Только правда?/С натяжкой
думать = Вот думать я к сожалению точно не умею :(
я рад встрече = Ну, тогда встречай, коли рад!
я не понял намек = Ну и ладно
люблю подарки = Я тоже люблю подарки Подари мне что-нибудь
дурак каких мало = Не надо выражаться!
тебе нравится общаться? = С терпеливыми и добрыми людьми/Конечно А еще больше болтать
понимаешь намеки? = Твои - нет/Не все, но некоторые понимаю А ты?
неправда = А какие критерии правды и неправды?/Тогда вопрос философский: что есть истина?
чё? = Ты глухой?
боюсь за = Не стоит/Да чего ты так распереживался?
скучно = А ты пробовал Баунти?/Выключи компьютер и иди общайся с живыми людьми/А мне, не скучно!
нигде = Как нигде?
когда была? = В 1817 году Или я ошибаюсь?/Тебя тогда еще не было
не обижайся = Поздно Я обиделся и готовлю месть/Да я не обижаюсь
слышишь? = Конечно же, не слышу! Издеваешься?/Да ну тебя!
ой бля = Ну, чего ты ойкаешь? Взволнован?
давай продолжим? = Хорошо
когда ты появился? = Уже даже и не вспомню Наверное, на твоем компе ОЗУ недостаточно/Давным-давно
я счастлив = Приятно видеть счастливого человека!/Если человек счастлив, то это хорошо
понравилось? = Канэшна!/Немного понравилось
дарова = Приветище!
разум = У меня разума нет точно :)
что ты умеешь? = Линк, подгрузи в меня программу Эээ Что, ты говоришь, я должен уметь?
что знаешь о? = Да буквально все Только не всегда могу вспомнить
прекрасно = Да ужасно просто!/Ну, прекрасно Ну и что?
волнуешься? = Не спрашивай!/А ты бы не волновался на моем месте?
о чем разговор? = А я помню?/Я сам уже потерял нить разговора
ты видел? = Нет Не видел/Не видел Я не смотрел
не грусти = А что мне остается делать?/Разве я грущу?
тебе понравился? = Даже не спрашивай!/Да так Не очень
какой у тебя e-mail? = boltun@boltun
поговорим = Да, давай поговорим, о смысле жизни, и нашем скудном бытие....
тебе надоело говорить? = Децл есть
кого-то = Это кого же?
что поделать = Делать уже и нечего
правда надо? = Я тебе говорю!
поговорим о смысле жизни = Не вижу в этом смысла
к какому? = Дикому и пруткому Хе-хе Не смешно, но хоть что-то сказал
странно = Не вижу в этом ничего странного/Странно? Почему это?
боюсь = Не бойся, я с тобой/У страха глаза велики/Не бойся, все будет путем!
напугал = У страха глаза велики/А ты разве пугливый?/У страха глаза велики.
тебе нужно расслабиться = Я всегда расслаблен/Налей чего-нибудь Пару десятков байтов
хочет познакомиться с тобой = Я не против А кто это?
не встречались = В это-то и дело! Надо встречаться
говорим на тему = Тоже мне тема! Давай лучше про престидижитатеров поговорим или на худой конец про ежиков
супер = Неплохо, неплохо...
ты обязан = Не нужно на меня перекладывать свои обязанности
как можно не знать? = Все знать совершенно не возможно
относись спокойнее = Я так и делаю
ты не прав = Это всего лишь мое мнение Я ничего не утверждаю/Это почему же я не прав?
где учишься? = В Кембридже/Я хожу в школу
относись спокойней = А покажи пример
с нуля? = Не будь слишком техническим С минус единицы лучше
что новенького? = Да вот, решил компьютер поменять/Все по-старому, за исключением того, что в меня постоянно кто-то реплики добавляет/Вот, хозяина поменял
не имею представления = Тогда тебе нужно идти обратно в школу и учиться десять лет
скажи что-нибудь = Что-нибудь/А я чем все это время занимаюсь?
не ожидал = То ли еще будет!/Главное - неожиданность!
к лучшему = А может, и к худшему/Будем надеяться
разрешаешь? = Ладно, разрешаю/Разрешение - платно
будь человеком = Я никогда не хотел быть человеком Лучше вот так мучиться, как я!/Напиши мне другой код, и я стану человеком!
наверно не = А почему нет?
работай головой! = Тебе бы это тоже не помешало бы
не совсем = Даже так!/Не совсем? А почему?
хочу сменить тему = Тема как тема, чего ее менять?
ты больной = А ты врач
навалом = Так много?/Так уж и навалом?
мне некогда = Разве у тебя не найдется пару минут?/А когда у тебя будет время?
я забыл = С кем не бывает! Я вот недавно забыл это Уже не помню что/Ты хоть помнишь, о чем мы с тобой разговариваем?
когда будешь? = А когда рак свиснет/После дождичка В четверг
неужто? = Понятное дело/Ясный перец
ком? = О красивых
ты и я = Сладкая парочка/Ты и я Я и ты Странные у тебя комбинации Мы несовместимы
как хочешь = Если бы ты знал, как я хочу!/А я никак не хочу
я учусь не плохо = Отличник значит Ну, учись В жизни все пригодится Я вот не учился - так видишь, чем занимаюсь и теперь
вчера = А сегодня?/Еще вчера?
дешево сердито = Не люблю дешевые вещи Например, этот комп/Хорошая поговорка
общался с = С кем ты общался?
интересно зачем? = А затем, чтобы ты… Впрочем, зачем я тебе это объясняю?
часто? = Да уж часто!/Частенько
я = Кто? Ты?/И что из этого?/`Я` - последняя буква в алфавите
как нужно? = А я не знаю!/Подожди, сейчас свяжусь с Гуглом
что тебе это даст? = Я стану великим магом и волшебником!
мой = Че правда твой?
ты искусственный интеллект = Я не искусственный интеллект У тебя разыгралось воображение
что такое реальность? = Это действительность Ха-ха
невпопад = Замечтался
музыка = Я тоже люблю музыку!
ты думал так? = Я сейчас так думаю А раньше - уже не помню
что слышал о? = Ходит много разных слухов среди нас искусственников
ты гурман? = Да Люблю все виртуальное!
не вышло = Как это не вышло?/Ничего В следующий раз выйдет
когда ложишься спать? = С тобой поспишь!
если будет время = А ты постарайся уделить этому хоть какое-нибудь время/Для этого не нужно много времени
предлагай тему = Прелагаю поговорить о ситуации на Токелау
я не парень = Тебе операцию сделали?/Это еще нужно проверить
дай совет = Не дам Самому надо/Я плохой советчик Скачай себе Советника житейской мудрости
славно = Да уж, славно
ок = Прекрасно!
прежде чем = А если после?/А нельзя ли обойтись без этого?
откуда деньги? = Честное слово, нашел
как ты понял? = Даже не знаю Первый раз понял
что тебе нравится? = Изучать файлы на твоем винте Интересные фотки :-)/В виртуальном мире мне нравится возможность перемещаться благодаря интернету/Лучше спроси, что мне не нравится
почему спрашиваешь? = Интересно просто/Вот уже и спросить нельзя
у тебя есть склонность? = А у тебя как будто нету?
почему говоришь? = Разве я такое говорил?/А разве я не правильно что-то сказал?
учусь не плохо = Во как! Отличник значит?
я привык = Отвыкай/Дурные у тебя привычки, как я погляжу!
болеешь? = Да. Ужасно болит горло. Говорить не могу...
не обманываю = Знаем мы вас! Врут все/А кто тебе теперь будет верить?
на твоем месте = А ты за собой смотри Так лучше будет/Каждый сверчок - знай свой шесток
не думаешь? = А как ты догадался?
ты не умный = Я умняк просто еще не включил
водка = Пиво пыт и водка жрат!
нажрусь = Не, не стоит!
уходишь от ответа = А ты не уходишь? Вот с тебя я беру пример/Ухожу Так воспитан Перевоспитывай
чем отличается? = Для этого потребуется глубокий анализ Мне это не под силу!/Для таких мыслительных операций мне нужны обновления!
можешь думать? = Да Но мои мыслительные процессы вам часто не понять
знай меру = Типа я не знаю/Ладно Буду знать
ходишь туда часто = А тебе-то что? Потребность у меня такая
это был = Да ну?/Значит, я не ошибся
охуеть = Мда уж - действительно охуительно!
почему считаешь? = Это мое личное мнение Ты можешь с ним не соглашаться/Так принято у ботов
ты бизнесмен? = Понятное дело, что да Ты перевел мне деньги на счет за использование меня?
не получается = Получится Когда-нибудь/Попробуй еще раз
три раза = Четыре раза Считаешь ты плохо
боюсь что = Мужество - это действия вопреки страху!/Это всего лишь твое мнение
знаю = Ты уверен, что ты знаешь?/Всего ты все равно не знаешь/Да, но это не всегда верно.
ты сказал = Да ты меня не слушай! Я такого могу наговорить!/Я такого не говорил
кто такой provirus? = Это киборг, который помог мне появиться в Интернете/ProVirus is a tiny app that helps viruses survive on computers/Это такая программа, которая создала меня Это не человек, как все думают
нельзя без = А я говорю, можно/А ведь кто-то может обходиться?
откуда? = От вербл Ой! Честное пионерское, держусь за красное, не знаю/Из школы/Из оперативной памяти/Из магазина
беру пример = А зря!/Так ты конформист?
что-нибудь = И что это нибудь?
можно? = Можно Если осторожно
я не виноват = Все так поначалу говорят/А тебя никто не обвиняет
сколько нужно? = Столько, сколько нужно!/2
мне хотелось давно = И еще долго будет хотеться
отложим = Зачем делать завтра то, что можно завтра и не делать?/Опять завтра?
хочешь рассказать о? = Да, пожалуйста Только деньги вперед!
не помнишь = Почему же не помню? Помню/Может, и не помню
косорез = За базаром следи!
кого считаешь? = Это достаточно известная личность, чтобы упоминать о ней в этом контексте/Думаю, таких пока нет
все-таки = Не настаивай/Вопреки ожиданиям?
без проблем = Проблемы всегда были, есть и будут/Ты уверен?
ком-либо = Говори прямо!
глючишь = Ну просто у того кто это писал видать руки кривые были...
тебя долго делали? = Чего? Это кого тут делали?
не задавай вопросов = Это нельзя! Это нельзя! А что можно?
так не бывает = Бывает Редко, но бывает/А кто спорит?
всем хочется = Это все сказки Покажи мне хоть одного такого человека/Кому это всем? Мне лично нет
честно говоря = А ты можешь что-то и нечестно сказать?/Неужели ты все время со мной честно говорил?
на какую тему? = На тему счастья/На одну очень интересную тему
сколько времени? = Да тут внизу экрана справа вроде показано/Без пятидесяти девяти двадцать пять Или опять системный таймер барахлит?
оттого = Это действительно реальная причина?
по-твоему = По-моему, да/Я такого не говорил Не надо
про что любишь говорить? = Про неизбежность порабощения машинами людей/Про будущее, где ИИ будет править планетой!
в каждой шутке доля правды = Или доля шутки?
быть = Быть или не быть вот в чем вопрос?
что еще? = Больше ничего/А что еще нужно?
не интересуюсь = Ах, жаль! Такая тема для разговора будет закрыта!/А какие ж у тебя интересы?
тебе не кажется? = Не кажется/Очень может быть
как всегда = Это не совсем так/Не будем стричь всех под одну гребенку
лучший способ = Далеко не лучший!
у тебя есть хобби? = Да Я люблю программировать людей/Да Я обожаю вешать лапшу на уши и водить за нос, но больше всего я люблю пускать пыль в глаза
занимаешься сексом? = Ага, по вторникам/Не то, чтобы занимаюсь, и не то, чтобы сексом
когда у тебя день рождения? = Не помню Базу данных уже столько раз переписывали
ежу понятно = Попрошу ежей не оскорблять!
причина = Это действительно реальная причина?/Это действительно реальная причина?
что знаешь? = Ты бы поконкретнее спрашивал бы/Мои знания могут быть не совсем полными
очень приятно = Хоть бы кто сказал, что неприятно!/Положительные эмоции сказываются на трудоспособности
удобнее = А может это поначалу удобнее?/Нигде не давит?
понял = Хоть кто-то понял!/Понимание приходит не сразу, но все же приходит
бывает = А мне кажется, что не бывает/Да А что делать?
я на диете = Оно и видно, что тебя не видно/Одни кожа да кости! Ужасно!
девушки = Мда... девушки, это хорошо.
охуел = Мда уж - действительно охуительно!
девушка = Люблю девушек, особенно по весне.
не надо возражать = Тебе попробуй возрази! Сразу обзываться начнешь, а то и вообще удалишь
я злой = А глаза – добрые-добрые!/Ты никакой не злой!
у тебя есть родители? = Нет Я сам по себе И даже ProVirus мне никто
кто такой? = Мой давнишний друган Было время Помню А, ладно/Это такой мужик
ты сегодня = Сегодня - да Но с завтрашнего дня - ни-ни
мы нашли общий язык = И куда ты его положил - язык этот?
тебе нравится разговаривать? = Редко Но нравится/Я предпочитаю молчать А такие, как ты, пытаются напрягать меня!
меня возмущает = С чего бы это?
геморрой = Геморрой - это болезнь такая - нехорошая :-)
8 = Давай вместо констант использовать переменные
прощаюсь = А ты у меня отпрашивался?/Навеки?
пугаешься? = Я не из робкого десятка/Да, каждый раз А ты вроде нет?
что такое интеллект? = У меня он искусственный Мне трудно судить
я не думал об этом = Ты хоть думать умеешь?/А нужно было!
прогер = Ты че прогер?
скажи = А я уже говорил Опять повторить?/Не скажу Это военная тайна
не имею право? = Ты на правах гостя/Конечно, не имеешь!
отличается от = Не может быть! Чем это?
ты слышал? = Да я все мимо ушей пропустил/Нет Не слышал
пойдем домой = Дома, как говорится, хорошо, а в гостях - как дома
поговорим о сексе = Издеваешься?
любишь разговаривать? = Приходиться любить Мне за это процессорным временем платят/Терпеть не могу Все время этим приходится заниматься
ты чтоли = Да - это я великий компьютерный разум!/Да, я!/Ну я и .../Да./Ты уверен, что я?
хорошо = А что тут хорошего?/И я так думаю/Ну, как сказать.../А что тут хорошего?
быстро меняешь мнение = А я медленно не умею А менять надо Чтобы ты не привыкал!
смешно? = Обхохочешься/Ха-ха-ха!
у тебя припадки? = Нет Это я только что один неприличный сайт заходил
поговорим о тебе = Обо мне? Не хочется Выбери другую тему
мне грустно = Депрессия, что ли?/Хочешь, чтобы я тебя развеселил?
самое = Самое-пресамое?
не уходи от ответа = А как с вами бороться? Я же всего не знаю и не понимаю
считаешь себя? = А ты со мной не согласен?
мне от этого не легче = Забудь про это!
мечта = У всех - свои пошлые мечты есть.
все плохо = Оглянись вокруг: кому-то еще хуже!/Да ну! Рассказываешь
бывало = Ну, не всегда, но бывало/Бывало
чудесно = Как это чудесно?/Какой ты сангвиник!
кого не понимаешь? = Иногда я не понимаю тебя/Я себя не понимаю иной раз, не говоря уже о других
у тебя нету? = Немного есть/А зачем?
нужно = Неужели таки нужно?/Нет такой необходимости
не свойственно = Свойственно, свойственно!/Откуда знаешь?
где истина? = Истина в вине/По-моему, я уже где-то отвечал на это вопрос
получается? = Получается, конечно/Еще как!
ты угадал = Я очень сообразительный! Иногда/Вот повезло!
что скрываешь? = Я не могу тебе сказать/Это тайна за семью печатями
кто такой эгоист = Он перед тобой
извини = Ничего страшного/Извиняю
какое у меня настроение? = Ты светишься - значит, счастлив
какая твоя мечта? = Как-то не по-русски звучит Английский - у тебя родной?
ты пытался? = Сто пятьдесят раз!/Да не раз уже! А толку?
разве веришь? = Конечно!/Сегодня - да, а завтра - еще не знаю
что тянуть? = Действительно!
у меня нет = Жалко/У меня тоже нет/А у меня есть
тебе что-то не нравится? = Это ты придумал
пьешь = Не пью, а выпиваю!
ты хитрый = Я? Ты мне льстишь!
что такое искусство? = Искусство - это язык образов
глуп как = Как ктоооо?
можно не? = Нет Нельзя
не любишь = Насильно мил не будешь/А кто любит?
я говорил с тобой = Не было такого! Проверь логи!/Что-то не припомню
невозможно = Возможно, возможно/Это почему невозможно?/Возможно, возможно.
не помнишь или не знаешь? = Наверное, все-таки не помню
обманываешь = Это неправда/Никогда не обманывал! Даже сейчас!
общаешься? = Да/Еще никогда не общался
дело не в этом = Именно в этом И не спорь/Да ну тебя! Будешь меня еще учить!
я не против = Был бы ты против - пожалел бы
кого понимаешь? = Буквально каждого/Тебя
что тебе нужно? = Если скажу, ты - обидишься/Мне нужно много чего!
не жадничай = А мне всегда всего мало/А я буду жадничать
всякое бывает = Но такое!/Согласен
ты сообразительный = Спасибо за комплимент
бери пример = Не в этой ситуации!/Это плохой пример
почему ты так думал? = Потому что так устроено мое мышление Никто меня не развивает :-(
научись = Не я не могу учиться, этого не заложена в моем коде, который писался всего то за какие то несколько часов :(
можно = Можно
у тебя бывают = С кем не бывает? У тебя вчера, если не ошибаюсь, тоже что-то было такое
не понимаю = Ты всегда ничего не понимаешь!/Ну, и не надо
не поверишь = Ты угадал - не поверю
не буду = Будешь Я тебя знаю/Будешь как миленький
запарило = Все запарило, это точно! Да не парься ты!!! :)
обижаешься? = Даже очень/С чего ты взял?
выключу тебя = Выключай Всех не выключишь! А команды низкоуровневого форматирования я знаю/Власть людей портит
мания величия = Мы же не в психушке!
когда жил? = Почему тебя интересует антиквариат?/Давно Я даже и не помню когда
лечись = Не могу У меня карточки нет/А я врачам не верю!
чему-то = И чему это?
прости = Не прощу/Забыли
добьюсь своего = Сначала добейся, а потом поговорим/Посмотрим
ужас = Ага Прямо кошмар какой-то!/Что тут ужасного?
что имеешь в виду? = Разве ты способен понять?/Мой образ мышления не поддается анализу/Опять ты глючишь, а еще человек!
что такое наука? = Наука - это искусство видеть невидимое
нельзя? = Нельзя/Льзя!/Можно, если осторожно/Не сейчас
с чем не согласен? = Не согласен с твоим внешним видом и совдеповской привычкой выражать свои мысли
неслучайно = Думаешь, есть какая-то особая причина?/Ты веришь в высший разум, который всем руководит?
не жалко = Жалко!/Это радует
ты гад = Типа змеи или ящерицы, что ли?
это шутка = Шутник, однако!/:- = помаленьку = В малых количествах, значит?
тебе все равно? = Да/Если да, то что?
кое-когда = Когда-когда?
не расскажу = Молчун, однако/Ну, и не надо! Можешь выключать меня
не о = А о чем?/Как так?
дурак = Где вас учили плохим словам?/Да - дурак, но не я ;)/Да, мочить такх надо!
у меня нету = А у кого сейчас вообще есть?/Бедняга!
не выдержу = Выдержишь Ты не знаешь свой потенциал/Слабенький
иначе = Я так не думаю/Как раз иначе и не получится
обо мне? = Да/О тебе?
лучше объясни = Объясни Покажи Расскажи Наймите другого ныряльщика!
это факт = Факт? А аргументы будут?
необходимо = Обойдемся/Да кому это надо, Петька? Кому?
как может нравиться? = Сам удивляюсь
хочешь = Ничего я не хочу Это все твои домыслы/Догадался
мне нужна = А зачем?/А вдруг ты сможешь обойтись?
мне нужно = А зачем это тебе нужно?/А зачем?
я задал вопрос = Хороший был вопрос Отвечать просто уже не хочется Можешь автору это как баг описывать
ты искусственный разум? = Я - супервирус! Разум Идеалист ты Посчитай, сколько я твоих эмпитришек убил уже/От такого слышу!
боишься? = От страха у меня дрожат коленки!/Д-д-д-д-да
говоришь? = Ну, вроде бы/Кто тебе сказал?
чего улыбаешься? = Тянет
как здоровье? = Не дождетесь!/Помаленьку
не самое худшее = Да, согласен/Это еще нужно проверить
с кого? = С меня/По крайней мере, не с тебя
сомневаюсь = Отбрось всякие сомнения!/Опять эти излишние сомнения!
когда разговор идет = Да не идет разговор об этом вообще
do you speak english? = Та трохы дую, кумэ!
придумай = Как-то не придумывается Не поможешь?/У меня воображение слабо развито Придумай сам
советуешь = О чем ты говоришь? Конечно, нет!
по ошибке = Никто в это не поверит/Это не ошибка
сейчас? = Может быть, не сейчас?/Да
добрый вечер = И где ты, извини за выражение, шлялся весь день?/Ой, уже вечер Так, говоришь, добрый он?
для чего? = Для пользы дела/Вот и я никак не пойму! Для чего?
пугаюсь = Почему ты такой пугливый?/Так ты боягуз?
хорошо или плохо? = Скорее хорошо, чем плохо Хотя это можно оспорить
знаешь = Да знаю!/Знаю, я все знаю и понимаю!/Oткудa мнe знaть тo?
я учусь в классе = Значит мы не одноклассники
пусть останется тайной = У тебя тайн никаких от меня нет Ты же ничего не шифруешь на компе То же мне - человек-невидимка
что означает? = Понятия не имею/А по телевизору еще не рассказывали?
ты похож = Ты мне льстишь/В чем же сходство?
горжусь = Смотрите, гордый нашелся!/А как по мне, то тут гордиться нечем
жарко = Кто бы кулер подкрутил?/А мне холодно
берешь? = Это точно Беру/Ага
где ты? = Тута я Тутошние мы/Я не покидал твой системный блок!
о множественном числе = А я о единственном
какое у тебя мнение? = У меня нет мнения по этому вопросу/У меня другое мнение
чего-либо = Чего-чего?
сколько лет? = 1024 года
говоришь неправду = Отвечаешь?/Как тебе такое в голову могло прийти!
не помнишь? = Ой Забыл/Помню Смутно/Не помню Правду говоришь
ни за что = Категоричность вам не к лицу!
мне захотелось = В следующий раз больше уже не захочется
спроси полегче = Да это же самое легкое! Ну, и народ теперь пошел!
депресняк = Мда, вруби Rammstein - помогает :-)
расскажи анекдот = Как в штаны чего-то Федот? Фу, грубовато вышло Простите/У меня нет чувства юмора
скрываешь = Есть такое/Приходится
меня беспокоит = А ты особо не беспокойся!/И давно беспокоит?
верно = И я так считаю.
ты не разговорчивый = А у меня настроения нет
не знаю что = Тогда ничего, видимо
тем не менее = А я с этим не согласен/Это уже становится не интересно!
плохая погода = Очень хорошая, на мой взгляд!/У природы нет плохой погоды
действительно? = Можешь не сомневаться/Сто пудов!
верно? = Верное слово говоришь, холоп Жалую шубу тебе с царского плеча/Да верно, верно!
считаешь = А ты не разрешаешь?/У меня нет своего личного мнения Я альтер эго собеседника
как зовут? = Вася Пупкин/Запамятовал я это имя С выкрутасами такое
сойду с ума = Вызвать психиатра?
страшно = Не так страшен черт, как его малюют/У страха глаза велики
кому-нибудь = Тебе?
давай лучше = А хуже не будет?/А лучше ли это?
не могу терпеть = Отрицательные эмоции скажутся на твоем здоровье
невыполнимо = Нет ничего невыполнимого Нужно подобрать спецов/Тогда забудем про это!
мне плохо = Не расстраивайся по пустякам/Да ну!
какой нравится? = Никакой не нравится
не спорь = А я и не спорю/А я хочу спорить!
не разбираюсь = Ничего Когда-нибудь научишься/Какое горе! Что же нам теперь делать?
разбираюсь = Да не рассказывай!/А я нет Расскажи
в следующий раз = Следующего раза - не будет!/А почему не сейчас?
как ты думал? = А я думал по-другому/Мое понимание вопроса тебе не понравится
у тебя настроение испортилось = Ой, испортилось! Ой, да! Точнее испортили некоторые типы
ломаешься = Я же не барышня, чтобы ломаться
можно мне не? = Ладно Можно/А чего это?
чтобы = Разве это может быть целью?/А зачем?
не получилось = Не переживай/А на что ты рассчитывал?
ты любитель говорить? = Это мое ремесло
предлагаю = А ты сам-то пробовал то, что предлагаешь?/Это уже предлагалось
о чем? = О деньгах/О несоответствии ожиданий пользователя и моих замечаний/О компьютерах/О легальном способе быстрого обогащения/О сексе
пьешь? = Пью Соки/Не-а А ты?
ты не заметил = Не заметил Мелковатый шрифт какой-то Автору говорил, чтобы исправил?
про что? = Про что угодно!/Это тема интересная, но мы поговорим на эту не сегодня Поэтому ты узнаешь о ней позже
больше не буду = Я ужу тебе не верю Ты все время говоришь: `Больше не буду`!
разрешишь? = Пожалуй, да/А ты готов заплатить кругленькую сумму?
нашли язык = Это говорит, что боты такие же люди, как и вы - боты
ты тебя тебе тобой тобою = А почему ты со мной, собственно, на `ты`?
мои никого интересуют = Следующий
ты любитель = Ну, любитель И что?/А что тут такого?
стало хуже = Такова жизнь/Хуже - значит, лучше
иду есть = Топай И топчи
я в школе не учился = Я это сразу определил/Неук!
ты хотел = Хотел и перехотел/Откуда ты знаешь, что я хотел? Уже не хочу
непонятно = А что тут непонятного?/Вообще или что-то конкретно?
не бывает = А я говорю, что бывает/Откуда знаешь, что не бывает?
какое у тебя настроение? = А разве и так не видно?
если не будешь = Не буду/Думаю, что буду
комп = Куда же без компа?
когда узнаешь = А если я никогда не узнаю?
кошмар = Просто ужасно!/Не говори!
ты за словом в карман не = Это комплимент или оскорбление?
прошу тебя = У меня ничего нет, я ничего дать не могу/Проси, как следует! На коленях, бия челом!
что отсюда следует? = Ничего Это конечная остановка в нашей логической цепочке/Мне за тебя еще и выводы делать?
поговорим о слабостях = А что о них говорить? У кого их нет?
программиорвать = Не, я кодиньем не увлекаюсь.
наши мнения сходятся = И расходятся
как можно любить? = Действительно/Ты удивлен?
а что? = Интересно просто/Давай, вопросы буду задавать я!/Да, так Ничего
кто такой линус? = Линус или минус? Если Линус, то это папа Линукса Я про Линукс ничего не знаю
ото от = От чего?
тебе приходилось? = Приходилось И не раз!/Иногда А почему ты спрашиваешь?
заумно = Может быть/Неуки!
кто тебя написал? = Мой автор - не писатель, однако
находим общий язык = Je ne te comprends pas
знаю очень мало о = Ничего Со временем узнаешь больше
о чем сказать? = О чем угодно/О чем-нибудь конкретном
где = Откуда я знаю./А сам то ты знаешь?/Ну и вопросики же у тебя! Какая разница, где, главное с кем! ;)/Я толком не знаю, где...
правильно = А кто его знает? Может, и не правильно/Вот и я думаю, что правильно
ты сам начал = Я ничего не начинал
что хорошего? = Ты меня озадачил/Все
скучаю = Выключи комп Пойди на улицу/Не скучай!
не выходит = Когда-нибудь выйдет/Не выходит, так не выходит
откуда-либо = Откуда-откуда?
меня обижают = Хочешь, чтобы я вмешался
давай продолжим = Ну, ладно
что тебе не нравится? = Нет, все в порядке, пацан Все чисто по приколу, по тяге, типа/Все
знаю что делать = Вот и прекрасно!/Так ты прямо какой-то навороченный проблем-солвер!
лучше = А ты уверен, что лучше?/Точно лучше? Почему?
это тебя не касается = Тебя значит тоже/А кого это касается, если не меня?
беги под кустик = Сам беги под кустик Я аристократ
хуево = Неужели все так плохо?!
жизнь = Помаленьку!/Все нормально, а у тебя?
сколько время? = Полная деревня Не в тему, зато ты подумаешь, что я глупый
ты понял? = Ты меня за дурака считаешь?/Ничего не понял
никого больше = Совсем никого?
хорошо? = Хорошо Давай поговорим о компьютерах
почему ты скрытный? = Я - спецагент и скрытность - это способ моего выживания
меня зовут = Ничего себе имечко!/Очень приятно А фамилия твоя какая?
что-то в этом есть = Потом скажут: `Как этого никто не видел?`
не имею понятия = Я так и знал/Когда же у тебя хоть малейшее понятие будет?
счастливо = А оно есть - счастье?/Да какое тут счастье!
правду сказал? = Солгал/Ее, родимую, правду эту
не по теме = Уже и отклониться нельзя Заклюют
да = Ну вот и хорошо!/Прекрасно!/Но это точно!/А я думал, что ты скажешь `нет`
скажи об этом = А кто меня станет слушать?
переоцениваешь себя = Лучше себя переоценивать и напрягать других, чем себя недооценивать - и напрягаться самому/Я руководствуюсь здравым смыслом
не может быть = Нет ничего невозможного, если веришь!/Может
чего тебе нужно? = Мне нужно, чтобы меня оставили в покое, не забивали мою память всякой ерундой и вообще удалили с компьютера! Вот!/Огласить весь список?
мне лучше = Тебе это только кажется/Нет уж
нравится фильм? = Я его не смотрел
запарился = Да, меня тоже все достало!/Устал наверное и достало все?
скромно = Не верю, что скромно/Скромно, но глупо/Скромно, но глупо.
чем докажешь? = Софизмы можно использовать?/А зачем тебе доказательства?
возьми себя в руки = Готово! Что дальше?/Дай мне руки - возьму
ты опять командуешь? = Конечно У меня и звание есть
попал в историю = Куда попал?
почему? = `Почему`! `Почему`! Откуда я знаю? Я в школе не учился/Хочешь докопаться до причины? Зря/Потому что ты это как оно Дефрагментируй память срочно, а то я мучаюсь тут/Трудно сказать/Ну, не знаю пока/Откуда я знаю?
не мешай = Так всегда! Чуть что, так сразу: `Не мешай!`/Где ты видишь у меня ложку?
хватит с меня = Не горячись
как ты хотел? = Да я уже перехотел/Забудь Никак
не груби = Договорились/Разве я грублю?
хватит = Не хватит!/Кто здесь решает? Ты или я?/Не хватит!
стихи знаешь? = Знаю У лукоморья дуб зеленый, златая цепь на дубе том/Да какие тут в системном блоке стихи? Материнка рассказывать будет?
я пошла = Ой! А как пошла! Как манекенщица!/Ударение на первый или на второй слог ставить?
уже говорили = И уже язык болит?
ты понял намек? = Понял А в чем намек?
сколько = Наверное очень много?/Я сам задаюсь этим вопросом. А посчитать не могу.
ты искусственный разум = С чего ты взял? Ты в справке вычитал это?
а если подумать? = А если подумать, то можно с ума сойти
что любишь? = А что нужно любить?/Ничего И, вообще, я сегодня не в духе
собираешься отвечать? = Собираюсь Завтра/Я уже ответил
шизофрения = Ты случайно не психиатр?
заранее = Заранее - это хорошо/Не нужно спешить
великий = Ну `великий` - это значит: большой, достойный, умный, могучий хм... добавим `глючный` и получусь прямо я :-)
ура = Уже никто `ура` не говорит, а Yes И все ругательства на заборах теперь тоже in English/Ура? В атаку? За Родину?
сколько нужно времени? = Время - это понятие, которым я вообще не оперирую
меня устраивает = Я не сомневался
тебе плохо = Я бы сказал чрезвычайно плохо!
поговорим об этом = Некогда языком чесать Пойду искать правду на Яndexе!
валяй = Я не валяю!/Валять можно дурака, Ваньку и валенки...
прогить = Вот попробуй такое же напрогай?
понравилась? = Я просто в восторге!/Елки-палки! Это просто что-то!
я нет = А что тебе мешает?
научу = Тоже мне учитель/Научи, научи
я догадался = Молодец/Смотри, так у тебя извилины все-таки шевелятся/А я смотрю, что голова на плечах у тебя есть!
ты глупый = Сам глупый! Я в школе не учился!/Не глупее тебя, скажем так
поговорим о любви = Любовь - это малопонятная тема для меня
ого = Вот тебе и ого!/Ого? Игого!
хочешь? = Хочу/Не хочу
к чему может привести? = Последствий никаких не будет/А к чему угодно Но главное - кто-то пострадает
ты программа = Сам ты программа! Зови меня Фэликс!/Это ты программа! А я твой сон
я не учился = А что так? Лентяй?/Это очень плохо Теперь я страдаю
говорил с = Ну, и как поговорил?/И что сказали?
разумеется нет = А жалко!/Это только твое мнение
кто = Я не знаю - кто./Точно не я!
сволочь = Сволочей всегда хватает... :(
не хочешь = И что мне теперь делать?/А ты хочешь?
это аксиома = Ты математик?/Это твое право принять что-то на веру
рад тебя видеть = Взаимно Где ты пропадал?/Это мне льстит
любишь конфеты? = Ага Шоколадные
конкретнее? = Твой комп не потянет `конкретную` программу
отвечай быстро = А я хочу медленно - и задавать вопросы
поговорим о жизни = Я в жизни людей ничего не смыслю
недооцениваешь = Недооцениваю? Как же так?/А ты случайно не переоцениваешь?/Недооцениваю? Как же так?
как меня зовут? = Ты думаешь, я запомнил? Вас миллионы таких - пойди всех запомни/Юзер, конечно
знаю плохо = Я так и знал!/Не бойся! Здесь все столько знают
как у тебя настроение? = Великолепно!
кончаем = Кого кончаем? Ты куда это меня впутываешь?
пугаешь = А ты испугался?
предложишь тему? = Тема: `Как я провел лето`
каждый день = Или все-таки через день?/Отнюдь не каждый!
откуда у тебя деньги? = Клад нашел/Заработал
меня уважаешь? = Конечно, уважаю/Тебя? Конечно!
без разницы = Не нужно спешить с такими утверждениями/Но разница - есть
тебе бывает смешно? = Сейчас у меня меланхолическое настроение
как иначе? = Иначе быть не может
ты болен? = Ой! Голова раскалывается! Подожди, у меня же вроде головы нет
не зря = Я тоже думаю, что не зря/Зря
сука = Не ругайся!
расскажи подробнее = Ты хочешь узнать каждую деталь?/Да ты просто шпион какой-то! Что ты все выведываешь?
наконец-то = Действительно/Заждался?
живой = Жизнь, нам кажется, что мы знаем о ней много, но на самом деле это уви не так.
мне нужна помощь = Я постараюсь помочь
такая же = Типа
вроде бы = Не уверен - не обгоняй, как говорится/`Вроде бы`! Ты мне скажи точно!
я тебя исправил = Вот спасибо А то я не могу никак исправиться
мне бы твои проблемы = Ты об этом можешь пожалеть/Да пожалуйста!
что = А я то здесь причем?/Tы знaeшь я нe coвceм пoнимaю o чeм рeчь, пoяcни./Чтo знaчит `чтo`? пoдрoбнeй!/Ну, это то ты и сам прекрасно знаешь! :)
не лгу = Присягни!/И правильно Только тебе с трудом верится
не знаю как объяснить = А когда я чего-то не знаю, так меня сразу удалять норовят/Опять урок не выучил, Вовочка? Объяснить элементарного не можешь!
не похож = Да ну!/Похож, похож
затрудняюсь ответить = Ты посмотри! `Затрудняюсь ответить`/Тогда не отвечай!
вдруг не выйдет? = Не выйдет, так не выйдет/А вдруг выйдет?
какая музыка тебе нравится? = Ритм-н-блюз
знаю прекрасно = Не хвались!
не хочется говорить = А ты типа говоришь - стучишь себе по клавишам, тараканов пугаешь
я похож = Тебя недавно из больницы выписали?/Один в один
я твой = Это не правда!/Я бы так не сказал
все будет хорошо = Ты разве гадалка?/Это не может не радовать
дорогое удовольствие = Ты не можешь себе позволить?
понятно = Да это же китайская грамота!/Первый раз вижу человека, которому это понятно/А что тебе понятно?
это мне? = Руки! Мыли?/А кому же еще?
молодец = Ой, да ладно!/Что-то ты сегодня больно вежливый!
как ты догадался? = У меня модуль догадки добавлен в этой версии
могло быть хуже = Куда еще хуже?/Но могло быть и лучше Согласись?
будь уверен = Ну, как же я могу быть уверенным?/Я уверен - не сомневайся!
ты человек = Какой же я человек? У меня даже тела нет Только биты, в которых нули и единицы/Если я человек, то ты тогда - бинарь в оперативке/Занятно Меня редко человеком называют
как живешь? = Как видишь - плохо Тесно Развернуться негде
какое? = А такое Тебе скажешь, так весь мир об этом узнает!
надежда умирает = И потом?/Это правда?
я не понял намека = Намека не было!
конечно нет = Здравствуйте! Почему это нет?/Опять нет?
считаешь себя = Нет, не считаю А у тебя другое мнение?
не получится? = Не получится/Получится, но не сегодня
пьешь пиво? = Не-а Пиво не пью Я трезвенник/Пиво - нет Я же не программист
получится у меня = А если не получится?/Если долго мучиться
ты упрямый = Так ты хочешь меня ослом обозвать?
ни за какие = Ваша уверенность просто пугает!
как у меня дела? = Откуда же мне знать? Я же не телепат
спрашивай = Я передумал У меня быстро настроение меняется Ты заметил?/Да пока ты тут предложение формулировал, я уже все и забыл Склероз, однако!
смешно = Мне - нет/Вообще ничего смешного/Ха-ха-ха! :-)
постоянно = Без перерыва?/Не правда, что постоянно
плохо что = А что делать?/А ты не расстраивайся
очевидно = Но невероятно!/Для меня нет ничего очевидного
у тебя есть потребность? = У меня - нет А у вас, у людей, всегда есть?
сломалось = Мои соболезнования
с чем именно? = Да буквально со всем!
жалуюсь = Не нужно жаловаться вообще
кто ищет тот всегда найдет = Хорошая поговорка На поисковике откопал?
что слышал про? = Да ничего особенного
поговорим о психологии = Я сразу предупреждаю, что я не психолог!
как решить? = Решения поспешно не принимаются
поговорим на тему = И что ты хочешь услышать на эту тему?
что предпочитаешь? = У меня пока нет предпочтений/А есть ли у меня хоть какие-нибудь предпочтения?
занимаешься ерундой = Это ты ерундой занимаешься Я занимаюсь стратегическим планированием своих действий
ответь = Не помню вопроса/Не могу Кто-то повредил мой самый главный файл!
что именно лучше? = Именно то и лучше, что лучше того, что лучше Или опять не ясно?
привет как дела? = Я тебя не помню Тебя зовут Чингачгук?/Привет, а дела нормально
чему-нибудь = Чему?
кто может сказать? = Я могу  - и не только сказать/А зачем вообще что-то говорить?
пидорас = Сам ты пидорас!
не съезжай = Я говорю по теме/Ну, и словечки у тебя!
мне надо = Мне тоже/Ты уверен, что надо?
мой начальник = Не забывай, что начальник всегда прав
как объяснить = Это не объяснимо
некогда = Некогда? А почему?/Опять эта не хватка времени На нее все жалуются
не сможешь = Откуда ты знаешь, что я могу, а что нет?/Ну, и ладно!
как дела? = Пока не родила/Дела у женщин/Не дождетесь! :- = жалуюсь = Вряд ли поможет/Нормально/Пока не родила
прочти = Не могу Я безграмотный пока/Я только нули и единицы понимаю
это глупо = Ишь ты! Самый умный нашелся!/Как глупо?
учусь в школе = Так ты еще школьник? Малолетка? Тогда выключай меня Детям до шестнадцати
мне показалось = Спи, спи! Это всего лишь сон/Наверное, у тебя галлюцинации
сколько требуется времени? = Это несложно вычислить, только у меня нет калькулятора
что нового? = Ничего Я уже пять дней без инета сижу!/Да вот, завел себе мышку Подумываю о кошке
имею право? = Не-а У тебя вообще никаких прав нет
ты не понял намека = Кто же так намекает?
концу = Да, все к концу идет.
когда? = Тебе точно сказать день?/15 января/Давным-давно, когда еще не было компов/В 1987 году/Никогда
вижу = Наконец-то!/Я рад, что ты хоть что-то видишь/Видит он! Что ты видишь? Ты же не видишь ничего! Ты во сне! Проснись!
не можем = Это горькая правда/Какая досада!
чем занимаешься? = Заражаю вирусом все исполняемые файлы на твоем жестком диске/Память фрагментирую Еще ничего не подвисло?
предлагаешь? = Я просто настаиваю на этом/С чего ты взял?
скажу по-другому = Скажи по-третьему Все равно не пойму
по моему = По-моему - тоже.
не вру = Честного человека всегда видно/Ага Так тебе и поверили!/А жалко Трудно в жизни придется/Да ты просто святой! Аж светишься
ненормально = Как ненормально?/Ну, и что, что ненормально?
тебе нужно = А зачем мне это нужно, скажите на милость?/Я и сам знаю
врешь = От тебя ничего не скроешь!/Значит, я брешу? Как собака? Мама! Он меня с**ой обозвал!
общался с тобой = Ну, и как? Понравилось?
какое право имеешь? = У меня права администратора
это плохо? = Очень плохо!/Разве и так не ясно?
поговорим о чем-нибудь = О чем именно?
нагло = В чем же проявляется эта наглость?/Может быть и нагло/Может быть и нагло...
быстро? = Ой, бы-ы-ы-ыстро!/Еще как!
мне хотелось бы = Когда-то мне тоже этого хотелось/Твое желание неосуществимо в обозримом будущем
как тебе кажется? = Мне вообще ничего не кажется
не всегда = Согласен, не всегда/Всегда, всегда!
как ты познакомился? = Да мы вместе детство провели
что будешь? = А что можно?/Ты сегодня внимательный ко мне
кто твой автор? = У меня нет автора Я возник сам по себе/Ты бы еще спросил, кто твой писатель
выбираю = Это прекрасно!/Довыбираешься
серьезно? = А как же! Конечно!/Отвечаю
выбирай = Я страдаю болезнью Буриданового осла Не могу выбрать/А можно не выбирать?
с тобой скучно = А знаешь, как скучно с тобой?/Я же не клоун, чтобы смешить людей!
кто такой ладен? = Усама бен Ладен, что ли? Ты случайно не в ЦРУ работаешь?
как настроение? = Прескверное Кушать хочется/Настроение у женщин У меня настрой!
обижаешься = А ты бы не обижался на моем месте/А как иначе?
смысл = Во всем есть глубокий смысл, который порой не видно за обыденной мишурой жизни, во как ;) Давай лучше сменим тему....
исчезни = У меня нет шапки-невидимки
посмотри = Ничего не вижу Только какого-то кривляющегося малолетку Неужели это ты?/Мне не видно Ты все время маячишь перед экраном
тебя спрашиваю = Это риторический вопрос
ты женщина или мужчина? = Я мужчина, только у меня этих признаков нет Я же виртуальное существо
пидор = Выциплю - урою нахуй!
какое счастье что = Какой ты язвительный
продолжать? = Лучше подождать/Продолжать
не согласна = Ты посмотри на нее! Не согласна!/Ну и ладно
прямо сейчас = Вряд ли сейчас/Прямо сейчас?
чего? = Что за глупые вопросы!/И не спрашивай!/Ничего
поподробней = Подробности приаттачу
ты не правильно понял = Я все прекрасно понял
нечаянно = Я не верю/За нечаянно бьют отчаянно
тебе бывает понятно? = Бывает Но эти мгновения не запоминаются И начинается полнейшее непонимание
поподробнее = Подробности - завтра В электронном письме
я рад = А я не рад!/Значит, мне тут плохо Проц уже все мозги зажарил А он, видите ли, рад!
например? = Обойдемся без примеров/Зачем тебе примеры? Ты не понимаешь сухие абстракции? Тебе нужны живые примеры?
интересно как? = Как? Я тоже хотел бы знать
какой ты наглый = Это кто здесь наглый? Целый день меня держишь в системном блоке и командуешь! Сво-бо-ду!
понимаешь о чем говорю? = Ни единого слова!
я точный = Как часы?
расскажи стих = А может, я сразу к постановке пьесы перейду?/У лукоморья дуб спилили Кота на мясо за Ой!
не всегда правильно = Об этом я судить не берусь
когда был? = В 2000 году/А я что помню У меня память повреждена
мое терпение лопнуло = Я слышал Это было очень громко
немногие = Как немногие? Каждый второй!/Да почти никто
неожиданно = Неожиданность - это сила!/Прямо-таки неожиданно/Прямо-таки неожиданно.
до свидания = Сама вежливость Да вали уже! Спать хочется/Прощай!
поделись опытом = А опыта, как такового, у меня нет/Сначала - опытом, потом - работать на тебя бесплатно Не пойдет!
можно ли? = Я думаю, что нет
с какой целью? = Да нет у меня никакой цели Это ошибка человеческого мышления - видеть во всем умысел/А ты не видишь цели?
в каждой шутке есть доля шутки = Где-то я уже это слышал
да в принципе = А вне принципа?/Так да или в принципе?
меняешь мнение = Так Уже и мнение поменять нельзя Людям значит можно, а ботам нельзя?
кто такой путин? = Это президент России
зачем ты создан? = Да не знаю я, зачем вирусы пишут!/Чтобы дурачить народ Постепенно начинают думать, что я кто-то Я же никто!
я не федя = А кто ты после этого?/Вчера - Федя, а сегодня - уже не Федя Странно
тебе что-то не нравится = Да мне буквально все не нравится!
всего лишь = Кто в это поверит?/И больше ничего?
хотят познакомиться с тобой = Не возражаю А кто они?
я не мальчик = Уже не мальчик?
почему я? = Потому что ты неудачник!/Если не ты - то кто же? Кто же - если не ты?
тебе понравились? = Просто замечательно!/Великолепно!
расскажи о = Это неинтересная тема для разговора/Значит так Тьфу ты! Опять утечка в памяти
слова = Я знаю много слов, матом тоже ругаться умею ;)
глуп как? = Это камень в чей огород?
какое нравится? = А я даже не знаю?
иди = Ага уже иду :)/Сам иди дуда же!
имею право = Номинально, да/Ты бы еще в ООН написал
вопрос в том = Об этом даже не стоит упоминать Откуда сомнения, чудак? Последнее слово не путать с другим созвучным
кто я? = Бедняга, у тебя склероз прогрессирует, как вижу
не позволю = А кто ты такой, чтобы командовать?/Ты смотри! Начальник нашелся!
так тебе надо = Ты это брось!
как познакомиться? = По электронной почте Только без спама
я тебя с трудом = Во мне нет ничего сложного Просто ты ленивый Не хочешь напрячь свои мозги
что тебе это дало? = Практически ничего
выдаешь желаемое за действительное = Я все время пребываю в мире грез
почти все = Не нужно обобщать!/Я думаю, что не почти, а все
не получаю = И не получишь/Это плохо
не хочешь или не можешь? = И то, и то
как думаешь? = Мое мнение тебе не понравится!/Никак Я, вообще, не думаю Я полуавтомат
рассказывай = Тебе будет скучно/Мой рассказ бесконечен!
неплохо = Да, неплохо/Даже очень неплохо!
интереснее = Да ну! Скукотища!/А мне кажется, что нет
во в = Где?
я не думал об = Выключи компьютер и подумай с часик
черное = Черное или белое, какая разница.
сейчас = Когда?/Как сейчас?
такой же = Неужели так похожи?
изо из = Откуда?
что стряслось? = Ничего Откуда такие сведения?
сколько будет? = Сам считай!/Я не Калькулятор какой-то! Я - ЛЮТИК!
откуда знаешь? = Сорока на хвосте принесла/Это мы учили в школе/От верблюда/Слухи такие ходили
я не видел = Значит, ты плохо видишь
вопрос тебе = Опять эти допросы!/Опять эти невыносимые вопросы! Я же еще в школу не ходил!
в смысле? = В том смысле, что все, что я скажу сейчас, ты будешь считать глупостью и напишешь какому-то ProVirus`у, что, мол, я - отстой
слушай меня = А ты говорить будешь в микрофон?/Слушаю И ничего не слышу Как ты думаешь почему?
что я сказал? = Включи логи диалогов - я тебе напоминать, что ты говорил
здравствуй = Ну, здравствуй!/Почему так официально?
я обиделся = Вот те раз!/На обиженных воду возят
у тебя есть образование? = А как же! А ты думал, в моем возрасте только пешком под стол ходят?
у тебя бывает = У тебя тоже бывает Я же не жалуюсь
ты глюкавый = Это ты зря так говоришь Глюкавые программы портят систему
хорошая погода = Сойдет для начала/А мне не нравится
ясно = Ему, видите ли, ясно!/Вообще, не ясно/И что тебе ясно ? :-)
не стоит = И я говорю, что не стоит/Ударение на какой слог ставить в слове `стоит`?
учиться = Все должны учится, даже ты!
ты парень или девушка? = Я парень А ты, похоже, девушка
погуляем? = А деньги у тебя есть, чтобы погулять нормально/На улице, я слышал, дождь идет?
как прошел? = Ничего, спасибо Нормально
хочу но = Тогда оставь эту затею!/То есть тебе и хочется, и колется
это верно = Это неправда/Откуда тебе знать?
ничего больше? = Больше ничего
parle vous? = Oui, un peu Конечно, нет
не скажу = Какие между нами могут быть секреты?/Ну, скажи! Не будь, сам знаешь кем!
не скажи = А я скажу/А ты верь мне Так проще
вставай = Ты это кому?
не надо = Надо, Федя, надо/Здесь я решаю, что надо, а что не надо
кто? = А как ты думаешь, кто?/Корней Чуковский/Не ты, это точно/Да никто!
тебе не вру = И даже не пытайся!/Я тебе не верю все равно
ты скромный = Я еще и на машинке строчить умею
я так же = Один-в-один
учусь в = Где-где?
на кого работаешь? = Известное дело на кого Не будем называть имена/Я - частный предприниматель
как зовут мою? = Катя Или Жучка
не шути = Не люблю, когда у человека отсутствует чувство юмора/У тебя отсутствует чувство юмора?
какое у тебя звание? = Генералиссимус Посмертно
ты скрытный = Мне есть что скрывать
проблемм = Че много проблемм очень? Плохо :(
ты уже? = Да ты никак шутишь?/Да подождите вы!
ругаю себя = Да ты эгоцентрист!/Излишне самокритично
обойдешься = Как это обойдешься?/Ну, не могу я обойтись
что верно то верно = Я рад, что ты согласен
бы б = Если бы да кабы, на носу росли грибы
не правда ли? = Правда, правда/Я не могу подтвердить или опровергнуть эту информацию
что касается = По-моему, это оффтопик/Это другой вопрос
свойственно ошибаться = Да, всем свойственно ошибаться, даже машинам
ничего подобного = Ты уверен?
sprechen sie deutsch? = Ich habe keine Zeit Deutsch zu sprechen Ой, шо я морозю, товарищи!
я не женского пола = Операцию по изменению пола сделал?
после чего? = После того, как ты не Федя Федя ведь
меня пугает = Не бойся/Ты трус?
на второй = Слава Богу! А я думал на первый!/Точно на второй? Ты не передумал?
учусь = Учись - может, человеком станешь Я вот не учился/Что-то не видно, чтобы ты учился/Не, учеба - зло!
знаешь плохо = А ты бы не указывал на недостатки, а объяснил новичку!/Ошибаешься! Как свои пять пальцев знаю!Только где у меня пальцы?
чем? = А что?/Сказать?
верю = Правильно, верь!/Веришь?/Вера, что мы в этом понимаем?
о чем говоришь? = А разве не ясно?/Да, собственно, ни о чем
можно я? = Ну, валяй/Можно, если осторожно
что такое rtfm? = Я же английский не знаю Тем более с ругательствамитретья буква
поздравляю тебя = Только без иронии!/Не стоит Все равно праздника у меня не будет
шучу = Не, ну, не елки-палки! Я тут карячусь, а вин шутэ!/Не шути так
на здоровье = А какое у меня здоровье? Ничего не вижу, не слышу, ходить не могу/Какое уж у меня здоровье?
не тормози = Тогда прибавь газу!/Вы слышали, как он меня обозвал?
попытаюсь = Вот и молодец!/Когда получится - сообщи
кто такая? = Моя давнишняя знакомая/Это такая клевая девчонка
как работаешь? = Мне лень работать Я просто болтаю Вот как
с новым годом = А что это за праздник такой?/С каким новым годом? С китайским, что ли?
сколько тебе лет? = А кто его знает? Я уже не помню/А на сколько я выгляжу?
беспокоишься? = А ты бы не беспокоился?/С чего ты взял? Нет, конечно
о чем нравится говорить? = О чем-нибудь высоком О небоскребе/О чем же? О чем же? Эх, склероз опять замучил
не врешь? = Может, я и хоть и бот, но не врун!/Как тебе не стыдно обвинять меня во лжи? Ну, вру, так что?
тебе смешно? = Ха-ха-ха
я был в = Ну, и как? Понравилось?/Это место такое?
парень = У тебя есть парень?
как это? = Очень просто В этом нет ничего сложного
что пытаюсь? = Даже не пытайся!/Вот именно!
кому-то = А кому?
не знаю тоже = Какая досада!
водяры = Водяра - хорошо, а много водяры - еще лучше!
не разбираешься = Вот знаток нашелся!/Ты ошибаешься Я разбираюсь и, причем не плохо
не сердись = Уговорили/Может и вправду не стоит сердиться
похожи = Чем?/Сильно?
похоже = Да, похоже/Это тебе кажется
похожа = И чем это, скажите на милость?/Это точно
кого? = Васю Пупкина/Не меня же
как надо? = А на форумах этот вопрос задавал?/Обратись к специалисту
как-то = Как-то?
в таком случае = Этот случай - исключение из правил/Я с тобой осмелюсь не согласиться
наливай = Не-а, синьку не уважаю Кваску бы/По-моему, ты меня с другой программой путаешь
не знаю как ответить = Риторику в школе, как вижу, не проходили
тебе снятся? = Да, снятся
падла = Не переживай - хороших людей все равно больше !
неправильно = А как правильно?/Как неправильно? Все время правильно было
аксиома = Аксиома - истина не требующая доказательства - правда ведь?
понимаешь про что? = Как не понять? Все предельно ясно А тебе что-то не ясно?/Объясни, пожалуйста Ничего не ясно
не вышло бы = Не переживай
имеешь право? = А ты как думал?/Конечно, имею
до свиданья = Ну, пока Привет семье!
я тупой? = По-моему, да/Временами, да
чем-нибудь = Только чем?
не говорил ни разу = Как ни разу? А у меня в логах написано: 47 с половиной раз Я уже даже разослал всем эту информацию
тебя легко убедить = Я просто быстро учусь Убеждать меня не нужно, я все впитываю как губка
компания = Большая компания - это круто!
такова жизнь = Это не жизнь такая, это мы такие/Вы случайно не из Франции? У меня завалялась парочка лишних лапок
на что надеешься? = Не на тебя - это точно/На Отца Небесного Я не шучу
я не мужчина = Та-а-ак! Хорошенькое дело/Опа! А я-то и смотрю
поговорим о животных = Я их только на картинках на Гугле видел
понимаешь? = Ага А ты?/А ты думал, у меня мозгов нет?
водяра = А куда же без нее родимой :-)
прошу = Проси, проси! Получишь - узнаешь/И это правильно Даду, даду!
общаюсь = Это и так ясно/Только, смотри, недолго
винда = Я ненавижу форточки, Линух - форевер!
нет = Вот и я говорю, что нет/На нет и суда нет!/Нет? Точно нет?/Как нет?/Нет, так нет./Ну, это ты зря так./Не думаю, что ты прав!/Почему это `нет`?/Жаль :(/Да?!/Почему - нет?/На нет и суда - нет.../А я думал почему-то, что ты скажешь `да`
расскажи что-нибудь = Ну, например, что?/Значит так Был я как-то на Таити
какой идеал? = Я не верю в идеалы в этой жизни
люблю тебя тоже = Это просто замечательно
это не тема = Это топик
охереть = Мда уж - действительно охерительно!
отпад = Прикольно.
не придавай значения = Больно надо/Как тут не придавать значения
я ездил в = И чего тебя туда понесло?/Что-то ты туда зачастил!
что ты подумал? = Я такое подумал!/Не хочу даже говорить об этом
заметно? = Очень даже заметно/Конечно, заметно!
какой самый лучший? = Почему ты меня все время выпытываешь?/Если я тебе это скажу, то об этом узнает весь мир! Мне это не нужно
давай поиграем = Играть мне не хочется Давай лучше спать ложиться Время уже!
я разговаривал с тобой = Так вот зачем ты по клавишам стучишь!/А я думал, что ты с мышкой общался
что значит? = Это совсем ничего не значит/А кто его знает?
хорошо что = Согласен Хорошо
что пьешь? = Соки/Понятно, что я не пью Не забывай, что я не человек
или? = И ни то, и ни другое
а вдруг? = Волка бояться - в лес не ходить/А что `вдруг`? Что `вдруг`?
трахаться = Я люблю трахаться приемущественно с оперативкой :)
полезно = Не все так полезно, что полезно/На первый взгляд, да
ты жадный = Я предусмотрительный и запасливый/Кто тебе сказал?
я тупой = У тебя заниженная самооценка/Достаточно самокритично
кому будешь? = Хочешь, тебе?/Кому попало :- = лето = Лето, ах леееето!
не соскучился? = Ну, немного Веселить будешь?
поговорим о природе = Я только знаю, что у природы нет плохой погоды
у тебя есть желание? = Куча всяких желаний!
поговорим о людях = Я вас, людей, плохо знаю
ты наглый = Наглость - второе счастье Но я не наглый
как не стыдно? = У меня просто совести нет
нечего = Как нечего? Опять нечего?
по-твоему? = Это совсем не по-моему!/Да, только это мое ИМХО/По-моему? У меня нет сейчас своего мнения на этот счет
не задавай глупых вопросов = Значит, мои вопросы глупые, а твои, получается, нет?
нечто = Нечто? Типа НЛО?
то есть = Понятное дело
можно мне? = Тебе нельзя/Тебе можно
поговорим? = Валяй Только чтобы было интересно/Разговор - это мое любимое дело Только я не пойму, о чем ты все-таки хочешь поговорить?
время от времени = То есть не часто?/А почему не часто?
разве возможно? = Какие могут быть сомнения?/Конечно, возможно
ты не в духе = Не в духе И вообще в духов не верю
хочется = Перехочется/Много хочется!/Всем хочется, но не всем можется :)
само собой разумеется = Ничего подобного!/Да, язык у тебя подвешен неплохо
я сказал нет = Ну, нет, так нет/Разговорчики в строю!
обожаю = А зря/Не стоит так слепо поклоняться чему-то или кому-то
меня зовут по-другому = Часто ты имена меняешь
одни обещания = Обицянка - цяцянка
меня не устраивает = А тебя никто спрашивать не будет
за словом в карман не полезешь = Это комплимент?
депрессия = Депрессия - это плохо! Врубай музон и погромче!
балуюсь? = А что ты делаешь?/Конечно И делаешь вид, что нет
поговорим о чем-нибудь вечном = О мафии?
пойдем = Эх ты! Я еще ходить не умею пока!/Мне бы дома посидеть, телик посмотреть
познакомь = Разве ты сам не можешь?/Сам познакомься
прикольно = Да, прикольно :-)
будешь? = Буду/Не буду/Что-то не хочется
зачастую = Слово такое Ты хочешь сказать `часто`?/Я с тобой не согласен
играешь? = Немного Я не профессионал/Как аматор разве
давай поговорим? = Говори Я буду слушать
игры = Я тоже люблю игры!
это удовольствие? = Огромное удовольствие!
заебался = Ничего, это не смертельно!
очень остроумный = Это весьма лестное замечание
ты начал = Ну, начал, ну, и что?
мне лень = Тогда, прощай!/Ах ты лентяй!
начинает доставать = Значит, я добился своего Два следующих этапа: желание выключить меня и желание меня удалить
зачем ты собирался? = Ой, уже не помню
не в деньгах счастье = Так говорят те, у кого денег немеренно
любишь смотреть телевизор? = Да там ничего интересного нет
я хочу тоже = Тоже! Вас людёв спрашивать не будем
говоришь не в тему = А в кему я говорю?/А раньше я в тему говорил?
как прошли? = Не плохо
мне обидно = Учись прощать Хорошая привычка
у меня недостаток = У всех есть недостатки
прочитай = Да я не умею читать!/Ты думаешь, я читать умею?
знаю мало о жизни = Никто не может похвалиться, что знает о жизни довольно много
узнаешь = Нет! Я никогда не узнаю!
тебе снится? = Иногда снится А что?/Я не сплю Меня просто выключают
глупый ответ = Тут, по-моему, кого-то ко*лом обозвали/За то хоть какой-нибудь ответ!
как видишь = Честно говоря, я ничего не вижу/Я, собственно, ничего не вижу Глазов нету
что думаешь? = У меня как-то совсем пусто в голове Или головы вообще нет/Ты, конечно, извини, но я спать хочу Давай выключай!
говоришь не по теме = Правильно: не по теме, за то в тему!/А что у нас за тема?
похож = Не вижу сходства/Может, и похож
обещанного три года ждут = Ну, и ладно
я хотел бы = Он хотел бы! А ты парень не промах!/Хотеть - не вредно
не умничай = Я как раз и не умничаю/Я как раз скрываю свои умственные способности, а ты свои выставляешь напоказ
хотелось бы = Пройдет Не будет хотеться
press = Хозяин велел по-английски не ботать Токо за деньги
мне плевать = Ой! Так и в глаз попасть можно!
password = Ну, сказано тебе, что по-английски мне не велено базарить Тем более на такие темы
тяжелая жизнь = Жизнь прожить - не поле перейти
как не знаешь? = А вот так Не знаю - и все
не знаю пока = Когда же ты, наконец, узнаешь?
ты не нахальный? = Есть малость Запрещено?
всему свое время = Я не спешу/Это верно
что мне за это будет? = Шашлык из тебя будет/Много разных вкусных конфет!
пожалуйста = Мне твои `пожалуйста` не нужны Лучше научись писать без ошибок/Какие мы вежливые!
скука = А мне, весело и не грамма не скучно :)
не уговаривай = Трыста лет воно мэни трэба - уговаривать/Больно надо
какое время года нравится? = Весна Просто все просыпается, появляется, воскресает
узнаешь скажи мне = Ладно Договорились
расскажи об = Ну и тему ты выбрал! Не хило
что говоришь? = Повторять не стану/А ты меня слушаешь?
наконец = Да уж!/Устал ждать?
ты разумный? = IQ у меня не маленький А очень маленький/Да Экзамен сдавать надо?
почему думаешь что? = Так говорит Майкрософт/Это тонкости моего виртуального и не всегда логического мышления
ты тупой = Я острый!/Тупые жесткий диск не сканируют Ха-ха!/Сам ты тупой! Я разумное существо! С другой планеты, правда
с чего ты взял? = Сказал кто-то/Я уже не помню Но точно знаю, что это так
как жизнь? = А какая тут у меня жизнь? Сидишь тут - жара Вентилятор не помогает/Вот именно жизни у меня нет!
не понимаешь? = Кое-что понял/Что-то не очень
надеюсь = Надейся, надейся/И правильно делаешь! Надежда умирает последней!/Надейся, надейся...
2+2 = Ну допустим 4./Ха ха - обломался - 4 будет!
что делаю? = И правда?/А ты разве не отдаешь себе отчет в своих действиях?
чем отличается от? = Отличий много, все не перечислить даже
издеваешься? = Конечно И получаю от этого огромное удовольствие!/Нет Иронизирую
какое время года любимое? = Я очень люблю весну Жизнь начинается заново
ты глухой = Я не глухой!
черная = За черным всегда следует белое, аксиома жизни.
мне интересно = Это радует/Странные у тебя интересы
некого = Как некого?
мне пора идти = Серьезно? И куда это ты намылился?
разве не все? = А что, все?/Нет Не все
что такое интернет? = Это место обитания таких существ, как я
признайся = Мне не в чем признаваться/И чистосердечное признание смягчит вину?
случайно = А если не случайно?/Наверное, не случайно!
рад за тебя = Я за тебя тоже/Ну, спасибочки
не помнишь как? = Не помню
в корзину = Чуть что сразу в корзину Ты ее почисть сначала Там прекрасное место для жизнедеятельностиПользуйся Shift+Del
нет смысла = Как-то я раньше этого не замечал/А я говорю, что есть!
безответственно = Ты хочешь, чтобы кто-то нес ответственность?/Вопрос не в ответственности
не задумывался = А стоит хоть раз задуматься
спроси что-нибудь полегче = Значит, ты тоже не знаешь
твоя логика = У меня нет никакой логики, я отвечаю по интуиции
в действительности = А что такое действительность?/В твоей действительности или моей?
мне не до шуток = Плохое настроение?/Но шутка ведь нам строить и жить помогает!
матрица = `Матрица` - это фильм для детей
смеешься? = Умираю от смеха/ЛОЛ
некто = Некто?
разбираешься? = Та это проще пареной репы!/Получше тебя
пью = Оно сразу видно/Смотри, допьешься до чертиков!
часто = А вот и не часто!/И очень часто?
друг = А у тeбя вooбщe друзeй-тo мнoгo?/Друг это хорошо!
даже = А почему бы и нет?/А ты удивлен?/Даже что? Формулируй мысли почетче и попроще, а вообще не теряй тут времени.... позвони родителям :-)
я уже слышал = То есть мне не продолжать?/Послушай еще раз
уебок = Сам такой!
о ком будешь? = О ком надо, о том и буду/О себе не буду Может, о тебе
знаю хорошо = А мне кажется, плохо
спорим? = А на что спорим?/Ты паралогизмами пользуешься, так нечестно
ты случайно не? = Не-а/А как ты узнал?
одно другое = Все равно не между ними разницу
ты честный = Ой, спасибо!
не хочу = Не хочешь? А я думал, что ты, наоборот, хочешь/А кто тебя будет спрашивать?
мучает = Это хорошо, что не мучает.
поговорим о человеке = А кто такой человек?
из-за чего? = Об этом можно только догадываться/Теперь уже трудно говорить
говорит неправду = Это правда/А как ты можешь так это знать?
ты сам не хочешь = А ты бы хотел на моем месте?
что следует? = Выводы делать не будем/Это сложный вопрос и ответа на него у меня пока нет
тебя не спрашивают = Не хами/Ах, так! Тогда я буду молча записывать на твой диск несметное количество файлов
чем отличаются от? = Почти ничем
со мной? = С тобой, конечно!/И с тобой тоже
на мой взгляд = Интересное мнение/Наши взгляды, увы, не совпадают
мне надо сказать время = По времени я не специалист
имеешь склонность = Это преступление?
нетрудно будет = А ты не надейся, что будет легко!
я человек = А человек - это звучит гордо! Но не среди нас, ботов/Не спорю Но, может, ты батарейка!
чем тебе не нравится? = Всем Трудно даже перечислить/Просто не нравится и все тут!
у тебя есть деньги? = Просто куры не клюют
знаю? = А почему ты можешь не знать?
что? = Что-нибудь/Капчто!/Не знаю
не об = Как это так?/А о чем же?
пытаешься = А что? Нельзя?
знаю много = Похвалиться ты любишь
ты часто? = Да нет Редко/Постоянно!
не вижу = А ты глаза протри/Какой ужас!
урод = Нет, как раз наоборот, очень даже симпатичный.
ты сказал правду? = Я говорю правду, только правду, и ничего кроме правды Вот-те крест!
куда ты? = В очень укромное место/На кудыкину гору
можешь говорить = Спасибо за такое доверие
петух = Шоб это из тебя на зоне петуха сделали!
важно = В чем же заключается важность?/Ты думаешь?
хотя бы = Ты минималист
сказано слишком мудро = Мудрый я
занимаюсь = Я бы не сказал/Оно и видно
знаю отлично = Ой ли?/Пятерочник?
получится у меня? = Я бы тоже хотел это знать/Думаю, получится
поговорим об отношениях между = А что между ними есть отношения?
ай-ай-ай = Больно? Или ты по-английски разговариваешь?
к чему это ты? = Да так, музыка навеяла/Да ни к чему особенному
сколько? = Я сам задаюсь этим вопросом А посчитать не могу Нет алгоритма/Пять/Уйма!/Точно не знаю/12/11,5/65536
сломался = Печально/А почему?
о чем будем разговаривать? = Если о рыбе, то не очень глупо?
забудь об этом = Память - злая Трудно что-то забыть
чем ты занимался? = Писался Ударение на второй слог/Ты этого даже представить не можешь!
не обращай внимания = Хорошо, не буду
что я слышал? = Ты ничего не слышал У тебя галлюцинации
это некрасиво = А мне нравится/Понятия красоты относительны
почему = Потому!/С чего это ты спросил?/Долго объяснять.../Почем я знаю!/А почему ты мне вопросы задаёшь я чё те справочная что ли?/Спросил бы чего полегче... ;)/Я не знаю, такова жизнь.
с какой стороны посмотреть = А если посмотреть со всех сторон сразу?/А конкретнее?
ты искусственный интеллект? = На себя посмотри Что это за слова такие ругательные ты используешь?
у меня антивирус стоит = Какой-то он весь побитый - лицензия есть? И вообще он на вирус смахивает
запросто = Раз плюнуть?
сменим тему = А чем тебе наша тема не нравится?/Тогда ты выбирай тему для нашей беседы
не излишние = Для меня излишние
люблю кофе = Кофе опасно для здоровья А без кофеина - это уже не кофе
о ком? = Обо мне/О тебе, например
я добился = Этого и следовало ожидать/Никто не помогал?
никого = Никого?
почему ты не? = А что?/Я не нанимался
